"","Year","AreaName","CA1_3X2","CA1_3X3","CA1_3X1","LandValue","RentalRates","Inflation","Interest","CA45X10","CA45X120","CA45X130","CA45X140","CA45X150","CA45X160","CA45X170","CA45X180","CA45X190","CA45X20","CA45X200","CA45X210","CA45X220","CA45X240","CA45X250","CA45X260","CA45X265","CA45X270","CA45X280","CA45X290","CA45X300","CA45X310","CA45X320","CA45X330","CA45X340","CA45X350","CA45X360","CA45X370","CA45X60"
"1",1978,"Adair",9432,7994,75402,1036,NA,0.0762,7.18,64205,6148,4664,1484,55976,7487,10239,1883,5577,45983,2149,2621,26020,4249,-1779,6028,0,70353,55976,14377,4249,18626,951,0,17675,1395,223,19293,18222
"2",1978,"Adams",5938,7411,44008,999,NA,0.0762,7.18,41105,3184,2258,926,37512,6177,6412,1271,3415,30049,1703,1523,17011,2414,-1015,3429,0,44289,37512,6777,2414,9191,267,0,8924,920,127,9971,11056
"3",1978,"Allamakee",15730,7046,110830,899,NA,0.0762,7.18,71123,2380,852,1528,57068,8562,6309,1259,3697,63492,2199,3247,31795,2996,-2257,5253,0,73503,57068,16435,2996,19431,292,0,19139,2287,217,21643,7631
"4",1978,"Appanoose",15406,6706,103317,758,NA,0.0762,7.18,27096,2089,1028,1061,22951,2442,3184,854,2100,17576,1197,1087,12087,880,-1321,2201,0,29185,22951,6234,880,7114,201,0,6913,721,112,7746,9520
"5",1978,"Audubon",9016,7940,71589,1473,NA,0.0762,7.18,84864,4747,3341,1406,76424,11096,20977,1883,6514,63657,2426,2470,31058,5295,-1492,6787,0,89611,76424,13187,5295,18482,503,0,17979,1337,168,19484,21207
"6",1978,"Benton",23459,8542,200396,1978,NA,0.0762,7.18,126357,5527,3087,2440,106857,12109,19109,3465,10524,77027,3864,4909,52877,9989,-1509,11498,0,131884,106857,25027,9989,35016,2086,NA,32931,3295,446,36672,49330
"7",1978,"Black Hawk",136176,8445,1149994,2235,NA,0.0762,7.18,92523,3818,1684,2134,89282,9790,10380,3196,9266,48686,3233,5167,48250,8109,-710,8819,0,96341,89282,7059,8109,15168,1641,0,13527,4092,583,18202,43837
"8",1978,"Boone",26358,8684,228892,2168,NA,0.0762,7.18,89141,11908,10134,1774,77727,10159,12214,3051,8084,45776,2690,3882,37647,8670,-725,9395,0,101049,77727,23322,8670,31992,2399,0,29593,2801,403,32797,43365
"9",1978,"Bremer",24048,7985,192031,1723,NA,0.0762,7.18,71389,2555,898,1657,65852,7733,6815,2233,6516,43053,2782,2903,36870,6156,-770,6926,0,73944,65852,8092,6156,14248,793,0,13455,1824,276,15555,28336
"10",1978,"Buchanan",23129,7386,170820,1752,NA,0.0762,7.18,97253,3923,1938,1985,87506,9612,10908,2968,10028,58652,3734,4178,46078,8810,-789,9599,0,101176,87506,13670,8810,22480,797,0,21683,2435,274,24392,38601
"11",1978,"Buena Vista",20930,8655,181142,2177,NA,0.0762,7.18,121132,2866,945,1921,100501,16462,18106,2736,8106,70851,3321,4512,47258,10309,-604,10913,0,123998,100501,23497,10309,33806,1790,NA,32017,2839,381,35237,50281
"12",1978,"Butler",17715,8148,144346,2051,NA,0.0762,7.18,95691,3944,2080,1864,78043,9655,11977,2540,7740,59350,3184,3736,39211,8854,-682,9536,0,99635,78043,21592,8854,30446,1681,0,28765,2549,380,31694,36341
"13",1978,"Calhoun",13660,8407,114843,2312,NA,0.0762,7.18,99136,3846,2006,1840,82236,9407,20028,3085,7616,50571,2798,2867,36435,8905,-762,9667,0,102982,82236,20746,8905,29651,257,0,29394,1617,169,31180,48565
"14",1978,"Carroll",23076,8751,201945,1890,NA,0.0762,7.18,166916,7407,5521,1886,140835,28513,51224,2835,8034,134857,3476,4771,41982,6595,-2245,8840,0,174323,140835,33488,6595,40083,1939,NA,38146,3568,497,42211,32059
"15",1978,"Cass",17226,8331,143518,1304,NA,0.0762,7.18,82075,4632,3235,1397,69973,8172,16518,2070,6056,57238,2634,2812,31711,5760,-1788,7548,0,86707,69973,16734,5760,22494,1330,0,21164,1986,280,23430,24837
"16",1978,"Cedar",18895,8925,168637,2095,NA,0.0762,7.18,122783,3536,1355,2181,104002,12687,17684,3165,10698,80187,3687,4212,51869,10832,-838,11670,0,126319,104002,22317,10832,33149,2709,NA,30441,3036,454,33931,42596
"17",1978,"Cerro Gordo",48863,8471,413922,2182,90,0.0762,7.18,91066,3621,2125,1496,84000,8203,9354,2703,9825,41915,3410,4210,46295,8909,-231,9140,0,94687,84000,10687,8909,19596,1730,0,17866,3383,462,21711,49151
"18",1978,"Cherokee",16623,8139,135296,1772,NA,0.0762,7.18,126745,2498,903,1595,110178,14181,31439,2471,7108,92602,3308,3183,48488,6874,-2402,9276,0,129243,110178,19065,6874,25939,1136,NA,24804,2057,274,27135,34143
"19",1978,"Chickasaw",15472,8095,125242,1430,NA,0.0762,7.18,76548,2876,1475,1401,65088,7103,9640,2283,7353,49097,2747,2610,33352,6006,-897,6903,0,79424,65088,14336,6006,20342,566,0,19776,1532,179,21487,27451
"20",1978,"Clarke",8310,6901,57346,867,NA,0.0762,7.18,29340,3248,2282,966,29406,4006,4774,901,2336,20425,1199,1070,15120,1622,-991,2613,0,32588,29406,3182,1622,4804,192,0,4612,676,136,5424,8915
"21",1978,"Clay",19469,8613,167696,1967,NA,0.0762,7.18,101203,2870,1129,1741,82920,9739,19475,2429,6833,60178,2630,3648,38166,7418,-1274,8692,0,104073,82920,21153,7418,28571,1461,0,27110,2500,370,29980,41025
"22",1978,"Clayton",21824,7015,153102,1160,NA,0.0762,7.18,118571,4040,1372,2668,99813,14027,13453,2616,7469,103065,4185,5155,52908,7221,-2144,9365,0,122611,99813,22798,7221,30019,944,NA,29076,3649,386,33111,15506
"23",1978,"Clinton",58330,8071,470776,1688,NA,0.0762,7.18,141225,4292,2049,2243,124109,15021,32848,3395,11181,101445,4166,4365,53133,9373,-2306,11679,0,145517,124109,21408,9373,30781,2107,NA,28676,3082,450,32208,39780
"24",1978,"Crawford",19194,7594,145768,1549,NA,0.0762,7.18,116075,7129,4808,2321,101766,16075,23673,2793,7859,85993,3085,4660,43621,7175,-2425,9600,0,123204,101766,21438,7175,28613,1118,NA,27496,2842,342,30680,30082
"25",1978,"Dallas",28836,8466,244139,1684,NA,0.0762,7.18,70515,6027,4059,1968,70656,5747,10811,2507,7597,34450,2407,3846,37741,7289,-862,8151,0,76542,70656,5886,7289,13175,705,0,12470,2517,330,15317,36065
"26",1978,"Davis",9112,6449,58764,912,NA,0.0762,7.18,32053,3001,1839,1162,30744,3779,3391,1112,3222,21151,1376,1462,16402,2066,-1160,3226,0,35054,30744,4310,2066,6376,220,0,6156,780,129,7065,10902
"27",1978,"Decatur",9825,6055,59492,700,NA,0.0762,7.18,36472,2807,1899,908,30187,3526,5485,983,3397,25164,1471,1507,13818,1365,-1492,2857,0,39279,30187,9092,1365,10457,371,0,10086,1091,162,11339,11308
"28",1978,"Delaware",18786,7651,143738,1761,NA,0.0762,7.18,132885,3697,1565,2132,111171,18507,14718,2865,9151,111519,4356,5191,56383,8891,-873,9764,0,136582,111171,25411,8891,34302,1927,NA,32376,3542,418,36336,21366
"29",1978,"Des Moines",45985,8559,393578,1653,NA,0.0762,7.18,49550,2544,1385,1159,42305,3851,5438,1630,5372,23113,1843,2231,21940,4585,-533,5118,0,52094,42305,9789,4585,14374,1010,0,13364,1646,247,15257,26437
"30",1978,"Dickinson",15324,8707,133429,1650,NA,0.0762,7.18,67693,2380,1018,1362,57346,6451,16914,1587,4013,41801,1840,2207,24334,5025,-906,5931,0,70073,57346,12727,5025,17752,1386,0,16366,1623,233,18222,25892
"31",1978,"Dubuque",93716,8056,754943,1606,NA,0.0762,7.18,121664,2912,1104,1808,104311,16827,18696,2347,6178,113377,3575,3915,52773,5269,-1998,7267,0,124576,104311,20265,5269,25534,390,NA,25145,2449,257,27851,8287
"32",1978,"Emmet",13742,8308,114164,1977,NA,0.0762,7.18,68069,2195,1231,964,55011,5065,11210,1701,5321,34488,2132,2005,27577,6041,-762,6803,0,70264,55011,15253,6041,21294,1202,0,20092,1538,235,21865,33581
"33",1978,"Fayette",25791,7336,189208,1595,NA,0.0762,7.18,131359,4007,1761,2246,112688,15419,17588,3227,10416,91231,4191,6312,55535,9212,-1779,10991,0,135366,112688,22678,9212,31890,1504,NA,30387,4241,477,35105,40128
"34",1978,"Floyd",19835,8062,159903,1853,86,0.0762,7.18,79470,3410,1940,1470,65096,5841,7129,4026,7003,35283,3001,3618,34478,7145,-455,7600,0,82880,65096,17784,7145,24929,1333,0,23596,2476,310,26382,44187
"35",1978,"Franklin",12913,8577,110758,2300,100,0.0762,7.18,112315,3982,2345,1637,100466,12036,16817,3512,10152,64784,3298,4837,49814,9488,-757,10245,0,116297,100466,15831,9488,25319,1578,NA,23742,3343,426,27511,47531
"36",1978,"Fremont",9677,8403,81320,1376,NA,0.0762,7.18,70066,6122,4744,1378,60388,5897,14942,2899,5799,35256,2457,4435,23959,5051,-944,5995,0,76188,60388,15800,5051,20851,1905,0,18946,3177,388,22511,34810
"37",1978,"Greene",12152,9314,113179,1995,NA,0.0762,7.18,98396,10706,8608,2098,86995,10254,18904,2932,9255,49363,2981,4846,37823,8628,-921,9549,0,109102,86995,22107,8628,30735,2567,0,28168,3364,462,31994,49033
"38",1978,"Grundy",14201,9188,130484,2317,NA,0.0762,7.18,113108,3338,1134,2204,96409,12156,21638,2804,8847,63306,2842,4609,43513,8750,-745,9495,0,116446,96409,20037,8750,28787,3680,NA,25108,3693,590,29391,49802
"39",1978,"Guthrie",11994,7661,91889,1359,NA,0.0762,7.18,63836,5697,4240,1457,57444,7135,9896,1859,5189,39097,2215,2738,28412,4355,-1558,5913,0,69533,57444,12089,4355,16444,713,0,15731,1878,232,17841,24739
"40",1978,"Hamilton",18085,9121,164954,2426,NA,0.0762,7.18,118455,5456,3634,1822,102813,21148,15813,3181,9343,69422,3956,5723,43649,10045,-178,10223,0,123911,102813,21098,10045,31143,1205,NA,29939,3986,453,34378,49033
"41",1978,"Hancock",13928,9593,133615,2272,101,0.0762,7.18,101883,3006,1263,1743,85880,10035,14200,3098,9309,51298,3533,3358,42347,10068,-367,10435,0,104889,85880,19009,10068,29077,1387,0,27690,2126,288,30104,50585
"42",1978,"Hardin",21695,8583,186201,2249,NA,0.0762,7.18,117335,5353,3123,2230,103135,13588,21693,2702,8844,71319,2948,4349,49011,8528,-1139,9667,0,122688,103135,19553,8528,28081,1996,NA,26086,2961,434,29481,46016
"43",1978,"Harrison",16621,7505,124743,1252,NA,0.0762,7.18,72962,5635,4032,1603,58513,5265,7838,2446,7815,32564,2647,3187,29315,7967,-1137,9104,0,78597,58513,20084,7967,28051,832,0,27219,2047,245,29511,40398
"44",1978,"Henry",18970,8067,153026,1508,NA,0.0762,7.18,64517,2924,1719,1205,60242,9191,7641,1747,5734,38692,2318,2713,30898,5192,-346,5538,0,67441,60242,7199,5192,12391,1405,0,10986,1982,359,13327,25825
"45",1978,"Howard",11317,7574,85716,1253,NA,0.0762,7.18,67256,2751,1367,1384,55690,5954,6794,2028,6466,43132,2485,2596,29367,5059,-988,6047,0,70007,55690,14317,5059,19376,777,0,18599,1487,171,20257,24124
"46",1978,"Humboldt",12389,8879,110007,2551,NA,0.0762,7.18,80823,2060,867,1193,63573,7097,13666,2176,6144,40618,2263,2108,30119,8007,-320,8327,0,82883,63573,19310,8007,27317,1101,0,26216,1431,193,27840,40205
"47",1978,"Ida",9021,8574,77344,1539,NA,0.0762,7.18,90616,2967,1539,1428,78756,10355,22649,2037,6262,65948,2224,3005,32224,6147,-1621,7768,0,93583,78756,14827,6147,20974,1076,0,19898,1948,254,22100,24668
"48",1978,"Iowa",15765,8371,131963,1614,NA,0.0762,7.18,89811,4423,2705,1718,75649,10492,13885,2145,6959,65147,2881,4682,34605,6259,-1602,7861,0,94234,75649,18585,6259,24844,884,0,23960,3148,337,27445,24664
"49",1978,"Jackson",22313,7391,164905,1450,NA,0.0762,7.18,81165,3380,1557,1823,70091,9888,14148,1731,4894,71604,2595,3110,33725,3725,-2216,5941,0,84545,70091,14454,3725,18179,813,0,17366,2331,331,20028,9561
"50",1978,"Jasper",36690,8611,315938,1701,NA,0.0762,7.18,111835,9416,7024,2392,92759,12343,18077,3182,8962,75952,3434,3918,42843,8400,-1432,9832,0,121251,92759,28492,8400,36892,2810,0,34082,2908,466,37456,35883
"51",1978,"Jefferson",16164,7229,116857,1074,NA,0.0762,7.18,48214,2642,1561,1081,44608,5867,6835,1364,4419,30227,1880,2040,22203,3641,-542,4183,0,50856,44608,6248,3641,9889,309,0,9580,1377,185,11142,17987
"52",1978,"Johnson",79497,8238,654922,1919,NA,0.0762,7.18,89735,3489,1337,2152,78756,12659,11044,2336,6815,62087,3131,3825,38946,7184,-804,7988,0,93224,78756,14468,7184,21652,1002,0,20650,2705,427,23782,27648
"53",1978,"Jones",20112,7473,150302,1541,NA,0.0762,7.18,104061,3364,1630,1734,89357,13214,17729,2579,8075,80554,3118,3259,41383,7000,-1514,8514,0,107425,89357,18068,7000,25068,1610,0,23458,2366,354,26178,23507
"54",1978,"Keokuk",13304,8066,107314,1320,NA,0.0762,7.18,83397,4383,2950,1433,73765,12192,8179,2229,8500,58883,3501,2642,36522,6988,-638,7626,0,87780,73765,14015,6988,21003,1146,0,19857,1934,292,22083,24514
"55",1978,"Kossuth",22126,8375,185305,2334,NA,0.0762,7.18,175695,4945,2299,2646,154495,18171,23678,5220,14598,89370,6042,5705,81081,16465,-753,17218,0,180640,154495,26145,16465,42610,1440,NA,41172,3750,448,45370,86325
"56",1978,"Lee",43832,8098,354959,1444,NA,0.0762,7.18,56311,4198,2936,1262,49233,8370,7605,1471,4733,38025,2163,2813,22078,3674,-610,4284,0,60509,49233,11276,3674,14950,547,0,14403,2127,239,16769,18286
"57",1978,"Linn",167462,8974,1502853,1998,NA,0.0762,7.18,85324,4162,1964,2198,84906,8569,9795,3056,8391,46589,3622,4416,47057,7828,-917,8745,0,89486,84906,4580,7828,12408,1426,0,10982,3332,524,14838,38735
"58",1978,"Louisa",12079,7286,88013,1709,NA,0.0762,7.18,50912,2608,1485,1123,46420,5188,4183,2048,6421,24649,1974,1971,24635,4357,-259,4616,0,53520,46420,7100,4357,11457,767,0,10690,1461,220,12371,26263
"59",1978,"Lucas",10258,7784,79851,819,NA,0.0762,7.18,26698,3195,2404,791,24115,3992,2835,729,2090,19441,1094,1186,12189,1244,-998,2242,0,29893,24115,5778,1244,7022,246,0,6776,856,126,7758,7257
"60",1978,"Lyon",13065,7851,102573,1793,NA,0.0762,7.18,125233,3561,1631,1930,106968,18068,33558,2414,6163,95042,3049,3728,39988,6287,-2310,8597,0,128794,106968,21826,6287,28113,709,NA,27405,2165,254,29824,30191
"61",1978,"Madison",12762,7845,100120,1159,NA,0.0762,7.18,48716,7274,5788,1486,46875,8019,6951,1535,3889,32724,1875,2369,22237,3597,-1149,4746,0,55990,46875,9115,3597,12712,270,0,12442,1521,166,14129,15992
"62",1978,"Mahaska",22965,8250,189460,1392,NA,0.0762,7.18,105925,7443,5731,1712,85837,15327,18444,2578,6512,81078,3023,3165,36788,6163,-936,7099,0,113368,85837,27531,6163,33694,1374,0,32320,2048,236,34604,24847
"63",1978,"Marion",29235,8377,244897,1407,NA,0.0762,7.18,66608,9081,7526,1555,61359,10832,9628,2224,4947,49872,2489,2538,28701,3730,-830,4560,0,75689,61359,14330,3730,18060,869,0,17191,1681,237,19109,16736
"64",1978,"Marshall",42449,8874,376694,1855,NA,0.0762,7.18,82847,10379,8612,1767,77197,7493,12212,2502,8058,46171,2948,4330,39654,7459,-1081,8540,0,93226,77197,16029,7459,23488,2552,0,20936,3332,537,24805,36676
"65",1978,"Mills",13377,8459,113153,1413,NA,0.0762,7.18,63581,5166,4094,1072,50936,4209,13916,1916,5586,36563,1755,2596,20958,4528,-933,5461,0,68747,50936,17811,4528,22339,785,0,21554,1723,219,23496,27018
"66",1978,"Mitchell",12483,8086,100936,1801,80,0.0762,7.18,90950,2804,1357,1447,80125,10203,15615,2166,7380,58694,2974,2944,38843,6033,-885,6918,0,93754,80125,13629,6033,19662,743,0,18919,2017,233,21169,32256
"67",1978,"Monona",12237,7857,96145,1184,NA,0.0762,7.18,86253,4822,3210,1612,73548,7664,16534,2659,8321,46112,2767,4370,31233,8635,-1177,9812,0,91075,73548,17527,8635,26162,515,0,25647,2623,261,28531,40141
"68",1978,"Monroe",9393,6924,65037,880,NA,0.0762,7.18,26091,2660,1811,849,25805,3173,4434,841,2497,20295,1225,1140,12495,953,-1192,2145,0,28751,25805,2946,953,3899,68,0,3831,703,90,4624,5796
"69",1978,"Montgomery",13475,8440,113724,1313,NA,0.0762,7.18,62128,3183,1968,1215,51104,6506,13442,2074,5085,39164,1813,2486,19698,4139,-1072,5211,0,65311,51104,14207,4139,18346,632,0,17714,1755,203,19672,22964
"70",1978,"Muscatine",40476,8532,345352,1859,NA,0.0762,7.18,65708,2291,1169,1122,54985,6534,7696,1825,5560,38780,2247,2118,29005,5365,-556,5921,0,67999,54985,13014,5365,18379,1428,0,16951,1809,303,19063,26928
"71",1978,"O'Brien",17251,8771,151303,2168,NA,0.0762,7.18,161382,2811,993,1818,132931,22327,43327,2428,8067,113985,3334,5248,48200,8384,-1742,10126,0,164193,132931,31262,8384,39646,1927,NA,37721,3507,433,41661,47397
"72",1978,"Osceola",8415,8683,73064,1909,NA,0.0762,7.18,82626,2349,1216,1133,68577,8643,17628,1591,5164,51702,2266,2672,30613,5698,-943,6641,0,84975,68577,16398,5698,22096,721,0,21375,1546,179,23100,30924
"73",1978,"Page",19284,7766,149766,1220,NA,0.0762,7.18,79087,3956,2513,1443,67361,7781,11701,2529,5327,46941,2043,6619,31361,4311,-1233,5544,0,83043,67361,15682,4311,19993,980,0,19013,5208,515,24736,32146
"74",1978,"Palo Alto",13152,8334,109604,2049,NA,0.0762,7.18,99009,3034,1510,1524,83358,7983,15600,2691,7909,50230,3223,3676,42276,8888,-644,9532,0,102043,83358,18685,8888,27573,1787,0,25786,2598,369,28753,48779
"75",1978,"Plymouth",25038,8180,204806,1721,NA,0.0762,7.18,175455,5122,2534,2588,144884,26441,38231,3453,9115,136248,4368,5254,58022,10814,-2516,13330,0,180577,144884,35693,10814,46507,2179,NA,44330,3352,438,48120,39207
"76",1978,"Pocahontas",11826,8895,105192,2394,NA,0.0762,7.18,100483,3392,1677,1715,78964,8676,15176,2922,7469,45712,2999,3219,38503,10166,-612,10778,0,103875,78964,24911,10166,35077,2072,0,33005,2347,367,35719,54771
"77",1978,"Polk",302921,9568,2898238,2002,NA,0.0762,7.18,52967,4032,2834,1198,50798,2913,5001,2326,5918,18825,2052,3536,29052,6046,-368,6414,0,56999,50798,6201,6046,12247,1141,0,11106,2938,464,14508,34142
"78",1978,"Pottawattamie",86856,8097,703254,1392,NA,0.0762,7.18,185469,6569,3992,2577,153155,22770,48911,4148,12237,127613,4592,5359,55138,10106,-3276,13382,0,192038,153155,38883,10106,48989,1696,NA,47295,3608,478,51381,57856
"79",1978,"Poweshiek",19080,8304,158445,1617,NA,0.0762,7.18,78407,4147,2426,1721,67644,8584,8922,2137,6922,50545,3027,2876,35176,6297,-1354,7651,0,82554,67644,14910,6297,21207,899,0,20308,1915,252,22475,27862
"80",1978,"Ringgold",6228,7313,45544,805,NA,0.0762,7.18,41769,3925,2910,1015,38186,4428,6487,1167,4160,29728,1659,1676,18609,2159,-1601,3760,0,45694,38186,7508,2159,9667,353,0,9314,1002,133,10449,12041
"81",1978,"Sac",14550,8865,128986,1981,NA,0.0762,7.18,129254,3495,1957,1538,106735,17064,29294,2976,7576,93738,3159,4402,42264,7053,-1979,9032,0,132749,106735,26014,7053,33067,1795,NA,31273,2805,376,34454,35516
"82",1978,"Scott",158699,8893,1411372,2558,NA,0.0762,7.18,87997,1868,603,1265,71932,8058,11939,2407,7100,57280,2745,2641,37042,7474,-633,8107,0,89865,71932,17933,7474,25407,3056,0,22351,2429,399,25179,30717
"83",1978,"Shelby",14837,8563,127049,1497,NA,0.0762,7.18,104736,6743,4970,1773,85276,10702,23069,2399,7713,73717,3056,3342,34995,8097,-1830,9927,0,111479,85276,26203,8097,34300,1382,0,32918,2242,300,35460,31019
"84",1978,"Sioux",30268,8224,248932,1925,NA,0.0762,7.18,315140,6100,2896,3204,266917,53255,111378,3584,9535,276929,5060,7371,76734,7982,-5053,13035,0,321240,266917,54323,7982,62305,3209,NA,59098,4670,543,64311,38211
"85",1978,"Story",71311,7359,524809,2248,NA,0.0762,7.18,85396,14489,12355,2134,86574,9270,12038,3081,8863,40504,3006,4841,45475,9061,-437,9498,0,99885,86574,13311,9061,22372,2544,0,19828,3712,545,24085,44892
"86",1978,"Tama",20122,8032,161621,1808,NA,0.0762,7.18,108934,5129,2775,2354,100995,11765,17152,3445,10232,63530,3606,4231,50564,9124,-1465,10589,0,114063,100995,13068,9124,22192,1077,0,21115,3082,425,24622,45404
"87",1978,"Taylor",8421,7005,58986,906,NA,0.0762,7.18,41933,3437,2214,1223,36748,4453,4928,1368,3371,27841,1741,1968,18919,2301,-1241,3542,0,45370,36748,8622,2301,10923,405,0,10518,1015,156,11689,14092
"88",1978,"Union",13947,7062,98489,1011,NA,0.0762,7.18,35094,3818,2820,998,34911,5952,6126,972,2619,26063,1321,1275,16646,1517,-1243,2760,0,38912,34911,4001,1517,5518,244,0,5274,944,152,6370,9031
"89",1978,"Van Buren",8502,6982,59360,997,NA,0.0762,7.18,36968,3676,2489,1187,33803,4887,3585,1058,3441,24611,1511,1523,17798,2205,-747,2952,0,40644,33803,6841,2205,9046,349,0,8697,1035,157,9889,12357
"90",1978,"Wapello",40531,7416,300592,1003,NA,0.0762,7.18,35855,2095,1106,989,30845,3107,3707,1267,3854,20544,1517,1992,15401,2747,-718,3465,0,37950,30845,7105,2747,9852,540,0,9312,1575,226,11113,15311
"91",1978,"Warren",33645,8068,271451,1374,NA,0.0762,7.18,51354,8505,6849,1656,45343,7626,5167,1604,4123,32919,2059,2731,22033,3755,-1174,4929,0,59859,45343,14516,3755,18271,1445,0,16826,2042,300,19168,18435
"92",1978,"Washington",20127,8860,178326,1703,NA,0.0762,7.18,112556,3459,1818,1641,86587,18901,13051,2430,7840,81879,3517,3648,37200,8384,-90,8474,0,116015,86587,29428,8384,37812,4930,NA,32883,3220,563,36666,30677
"93",1978,"Wayne",8160,7098,57918,816,NA,0.0762,7.18,39855,3889,2873,1016,35352,3633,6346,1117,3951,25828,1645,1333,17327,2192,-1432,3624,0,43744,35352,8392,2192,10584,189,0,10395,692,93,11180,14027
"94",1978,"Webster",46513,8380,389762,2408,NA,0.0762,7.18,108593,5292,3386,1906,89115,12234,8811,3546,8928,41628,3436,5328,46832,11675,-373,12048,0,113885,89115,24770,11675,36445,1512,0,34933,3375,386,38694,66965
"95",1978,"Winnebago",13721,8083,110902,2106,96,0.0762,7.18,60008,3072,1806,1266,58144,5301,5804,1785,6065,25116,2132,2666,34391,6559,-111,6670,0,63080,58144,4936,6559,11495,469,0,11026,1376,166,12568,34892
"96",1978,"Winneshiek",21962,6640,145825,1249,NA,0.0762,7.18,107754,4532,1381,3151,89966,14074,13890,2247,6686,92724,3459,4503,45107,5737,-2465,8202,0,112286,89966,22320,5737,28057,852,0,27205,2749,328,30282,15030
"97",1978,"Woodbury",104157,8344,869119,1336,NA,0.0762,7.18,146941,5560,3303,2257,130080,19258,35036,3669,13164,100510,3874,5455,49624,10832,-2739,13571,0,152501,130080,22421,10832,33253,1266,NA,31989,3102,383,35474,46431
"98",1978,"Worth",9142,8147,74480,1997,NA,0.0762,7.18,65885,2417,1328,1089,58599,6389,11231,2089,7216,32747,2195,2275,27204,6599,-198,6797,0,68302,58599,9703,6599,16302,301,0,16001,1391,167,17559,33138
"99",1978,"Wright",16629,9363,155701,2445,NA,0.0762,7.18,96219,2981,1119,1862,76925,8126,9313,2989,8918,37076,3000,3152,41427,10909,-380,11289,0,99200,76925,22275,10909,33184,1236,0,31948,2153,266,34367,59143
"100",1979,"Adair",9545,7769,74152,1228,NA,0.1122,10.05,70309,2187,724,1463,66963,7468,13190,2135,6798,47008,2835,2982,31555,4344,485,3859,0,72496,66963,5533,4344,9877,467,0,9410,1529,221,11160,23301
"101",1979,"Adams",5847,7537,44070,1183,NA,0.1122,10.05,45719,1389,464,925,44655,5932,8265,1420,4113,30321,2087,1720,21118,2784,298,2486,0,47108,44655,2453,2784,5237,175,0,5062,1111,146,6319,15398
"102",1979,"Allamakee",15382,7147,109942,1135,NA,0.1122,10.05,75714,1784,319,1465,70927,8578,7881,1543,4525,66651,3143,3487,41770,2598,282,2316,0,77498,70927,6571,2598,9169,152,0,9017,2384,256,11657,9063
"103",1979,"Appanoose",15528,7510,116621,900,NA,0.1122,10.05,29416,1155,226,929,26498,2259,3573,896,2502,16867,1385,1175,14708,1582,NA,1544,0,30571,26498,4073,1582,5655,171,0,5484,763,106,6353,12549
"104",1979,"Audubon",8855,7572,67050,1749,NA,0.1122,10.05,94132,2086,677,1409,93547,11666,25777,2145,7822,68454,3176,3042,39919,4889,680,4209,0,96218,93547,2671,4889,7560,173,0,7387,1648,217,9252,25678
"105",1979,"Benton",23671,8786,207966,2323,NA,0.1122,10.05,134341,3217,797,2420,128313,12417,23065,3963,13297,77697,4950,5229,65392,7952,772,7180,0,137558,128313,9245,7952,17197,1092,0,16105,3628,468,20201,56644
"106",1979,"Black Hawk",136183,9486,1291849,2676,NA,0.1122,10.05,103250,2783,731,2052,105060,9785,12843,3629,11050,48811,3987,5547,58219,6558,533,6025,0,106033,105060,973,6558,7531,886,0,6645,4348,579,11572,54439
"107",1979,"Boone",26348,9224,243036,2518,NA,0.1122,10.05,100637,2335,662,1673,89497,9591,14789,3316,9552,47416,3222,4177,44850,7323,500,6823,0,102972,89497,13475,7323,20798,1843,0,18955,3116,408,22479,53221
"108",1979,"Bremer",24293,8554,207804,2117,NA,0.1122,10.05,77642,2115,411,1704,80415,8143,9053,2557,7895,45196,3463,3185,46119,4731,400,4331,0,79757,80415,-658,4731,4073,251,0,3822,2050,279,6151,32446
"109",1979,"Buchanan",23220,7774,180504,2137,NA,0.1122,10.05,108535,2479,690,1789,106751,10197,13932,3379,12288,58681,4594,4473,57888,7581,880,6701,0,111014,106751,4263,7581,11844,503,0,11341,2668,311,14320,49854
"110",1979,"Buena Vista",20636,8993,185577,2593,NA,0.1122,10.05,127094,2456,571,1885,120469,17043,23554,3226,10112,74341,4175,5403,56956,7875,999,6876,0,129550,120469,9081,7875,16956,982,0,15974,3412,454,19840,52753
"111",1979,"Butler",17827,8233,146765,2452,NA,0.1122,10.05,103354,2870,1020,1850,96525,10361,15366,3032,9596,58573,4110,4147,49913,7196,769,6427,0,106224,96525,9699,7196,16895,1030,0,15865,2814,390,19069,44781
"112",1979,"Calhoun",13499,9159,123637,2706,NA,0.1122,10.05,115655,2319,540,1779,96863,10266,24774,3270,8969,58141,3401,3222,42961,7714,498,7216,0,117974,96863,21111,7714,28825,350,0,28475,1731,192,30398,57514
"113",1979,"Carroll",22861,9350,213757,2255,NA,0.1122,10.05,191252,2684,716,1968,169527,27865,66925,3122,9300,151712,4466,5149,52700,7177,1117,6060,0,193936,169527,24409,7177,31586,1628,NA,29957,3857,510,34324,39540
"114",1979,"Cass",17227,8749,150711,1543,NA,0.1122,10.05,92654,2144,777,1367,83329,8134,20752,2356,7415,60396,3295,3055,38322,5503,434,5069,0,94798,83329,11469,5503,16972,923,0,16049,2114,284,18447,32258
"115",1979,"Cedar",18839,9158,172534,2515,NA,0.1122,10.05,130456,2465,424,2041,123572,12493,21300,3705,12997,78379,4615,4752,63710,8343,1284,7059,0,132921,123572,9349,8343,17692,1640,0,16052,3465,477,19994,52077
"116",1979,"Cerro Gordo",48492,9031,437934,2615,102,0.1122,10.05,96625,2897,1354,1543,100199,8622,11181,3154,11813,41439,4272,4518,56639,6813,658,6155,0,99522,100199,-677,6813,6136,541,0,5595,3451,444,9490,55186
"117",1979,"Cherokee",16422,8286,136071,2121,NA,0.1122,10.05,136573,2333,668,1665,132352,14276,40136,2752,8208,98749,3936,3597,59447,6210,539,5671,0,138906,132352,6554,6210,12764,529,0,12235,2270,298,14803,37824
"118",1979,"Chickasaw",15499,8411,130360,1758,NA,0.1122,10.05,83017,2038,705,1333,77774,7412,11616,2523,8703,51505,3532,2925,41063,4954,583,4371,0,85055,77774,7281,4954,12235,471,0,11764,1820,220,13804,31512
"119",1979,"Clarke",8450,7158,60482,1029,NA,0.1122,10.05,31346,1319,363,956,34449,3662,5364,1004,2818,21971,1530,1228,18843,1537,143,1394,0,32665,34449,-1784,1537,-247,NA,0,-238,744,126,632,9375
"120",1979,"Clay",19621,9132,179175,2344,NA,0.1122,10.05,113079,2401,697,1704,101116,10262,24392,2841,8603,64215,3422,4117,47479,6599,417,6182,0,115480,101116,14364,6599,20963,1188,0,19775,2753,379,22907,48864
"121",1979,"Clayton",21620,7152,154628,1464,NA,0.1122,10.05,128494,2823,440,2383,121828,15227,16126,3101,9346,109049,5437,5498,67093,5484,997,4487,0,131317,121828,9489,5484,14973,446,0,14527,3804,433,18764,19445
"122",1979,"Clinton",58324,8902,519188,2062,NA,0.1122,10.05,156685,3021,663,2358,148582,14514,38743,3912,14070,102937,5195,5059,67089,8364,868,7496,0,159706,148582,11124,8364,19488,1336,0,18152,3645,501,22298,53748
"123",1979,"Crawford",19286,7627,147102,1846,NA,0.1122,10.05,123257,3413,1097,2316,119520,15375,29159,3032,9304,88377,3992,4878,53780,6450,906,5544,0,126670,119520,7150,6450,13600,567,0,13033,2923,353,16309,34880
"124",1979,"Dallas",29044,9410,273294,1964,NA,0.1122,10.05,86058,2375,482,1893,85481,5450,13851,2897,9065,35697,3012,4070,47136,6681,252,6429,0,88433,85481,2952,6681,9633,651,0,8982,2699,337,12018,50361
"125",1979,"Davis",9194,7021,64553,1077,NA,0.1122,10.05,38279,1402,321,1081,37674,4166,4239,1267,3994,22223,1753,1649,20606,2649,276,2373,0,39681,37674,2007,2649,4656,143,0,4513,854,125,5492,16056
"126",1979,"Decatur",9806,5826,57130,831,NA,0.1122,10.05,36530,1225,325,900,37418,3565,7309,1064,4030,24464,1815,1753,17882,1637,89,1548,0,37755,37418,337,1637,1974,81,0,1893,1206,168,3267,12066
"127",1979,"Delaware",18709,7687,143825,2192,NA,0.1122,10.05,145111,2462,391,2071,137305,19505,18275,3321,11255,116173,5683,5735,73531,7629,1946,5683,0,147573,137305,10268,7629,17897,953,0,16944,3890,478,21312,28938
"128",1979,"Des Moines",45850,9511,436083,1944,NA,0.1122,10.05,58933,1502,417,1085,49489,4081,6485,1882,6315,23118,2265,2412,26049,4192,318,3874,0,60435,49489,10946,4192,15138,1142,0,13996,1935,259,16190,35815
"129",1979,"Dickinson",15725,8973,141106,1985,NA,0.1122,10.05,76906,1519,462,1057,70367,7566,21191,1832,5063,47912,2284,2490,29941,4065,260,3805,0,78425,70367,8058,4065,12123,935,0,11188,1836,248,13272,28994
"130",1979,"Dubuque",93425,8733,815877,2019,NA,0.1122,10.05,134189,2322,397,1925,128779,17843,23338,2683,7521,122298,4707,4639,68048,4983,1150,3833,0,136511,128779,7732,4983,12715,201,0,12514,3018,363,15895,11891
"131",1979,"Emmet",13515,8449,114194,2354,NA,0.1122,10.05,69818,1630,660,970,64748,4773,13399,2017,6405,35441,2622,2151,33381,4519,224,4295,0,71448,64748,6700,4519,11219,613,0,10606,1577,222,12405,34377
"132",1979,"Fayette",25176,7804,196480,1986,NA,0.1122,10.05,148390,3094,898,2196,138561,15930,22352,3780,12692,100130,5490,6867,71450,7534,854,6680,0,151484,138561,12923,7534,20457,1166,0,19291,4610,541,24442,48260
"133",1979,"Floyd",19626,8604,168868,2250,93,0.1122,10.05,87989,2863,1309,1554,79563,5827,9469,4044,8733,36315,3775,4086,43629,5644,445,5199,0,90852,79563,11289,5644,16933,1188,0,15745,2895,360,19000,51674
"134",1979,"Franklin",13054,8405,109715,2710,113,0.1122,10.05,123888,3047,1309,1738,121166,12706,21603,3952,12023,66573,4189,5327,61366,7838,786,7052,0,126935,121166,5769,7838,13607,925,0,12682,3742,469,16893,57315
"135",1979,"Fremont",9687,8782,85075,1630,NA,0.1122,10.05,81231,2180,880,1300,70568,6123,18868,2964,6716,35155,2824,4426,28647,4967,182,4785,0,83411,70568,12843,4967,17810,1577,0,16233,3173,385,19791,46076
"136",1979,"Greene",12251,9569,117234,2337,NA,0.1122,10.05,112425,2550,652,1898,98269,9672,21427,3234,10432,52466,3444,4990,45070,7672,423,7249,0,114975,98269,16706,7672,24378,2174,0,22204,3471,447,26122,59959
"137",1979,"Grundy",14417,9865,142230,2728,NA,0.1122,10.05,129070,2576,510,2066,112969,12172,25884,3115,10512,71473,3541,5173,52572,7042,606,6436,0,131646,112969,18677,7042,25719,3598,0,22121,4070,592,26783,57597
"138",1979,"Guthrie",11873,7897,93763,1598,NA,0.1122,10.05,72197,2249,795,1454,69586,7475,13021,2021,6504,43255,2748,2913,34904,4197,275,3922,0,74446,69586,4860,4197,9057,369,0,8688,1999,248,10935,28942
"139",1979,"Hamilton",18001,9713,174842,2827,NA,0.1122,10.05,134524,2322,610,1712,122760,22258,20736,3496,11100,73549,4832,6171,54167,8423,859,7564,0,136846,122760,14086,8423,22509,1068,0,21441,4269,502,26212,60975
"140",1979,"Hancock",13768,9395,129346,2691,112,0.1122,10.05,107752,2366,658,1708,100357,10350,16908,3518,10864,53734,4492,3650,50575,7433,889,6544,0,110118,100357,9761,7433,17194,863,0,16331,2321,300,18952,54018
"141",1979,"Hardin",22018,8965,197384,2621,NA,0.1122,10.05,132908,3237,1128,2109,126265,13606,27689,3248,11012,76500,3863,5257,61590,7709,791,6918,0,136145,126265,9880,7709,17589,1438,0,16151,3666,501,20318,56408
"142",1979,"Harrison",16640,7790,129632,1482,NA,0.1122,10.05,82556,2769,1164,1605,69516,5159,10000,2829,9539,35138,3324,3665,35000,6351,260,6091,0,85325,69516,15809,6351,22160,750,0,21410,2372,296,24078,47418
"143",1979,"Henry",18915,8599,162656,1772,NA,0.1122,10.05,74061,1563,366,1197,71366,9850,9515,2032,6985,40141,2743,2805,37436,4937,768,4169,0,75624,71366,4258,4937,9195,975,0,8220,2073,323,10616,33920
"144",1979,"Howard",11142,7903,88057,1541,NA,0.1122,10.05,72573,2034,583,1451,66254,6235,8552,2343,7475,44463,3267,2918,35464,4069,298,3771,0,74607,66254,8353,4069,12422,527,0,11895,1733,209,13837,28110
"145",1979,"Humboldt",12312,8713,107276,2981,NA,0.1122,10.05,83713,1558,465,1093,75933,7013,16483,2527,7703,42057,2884,2385,36938,5573,401,5172,0,85271,75933,9338,5573,14911,591,0,14320,1620,212,16152,41656
"146",1979,"Ida",9046,8113,73388,2070,NA,0.1122,10.05,95646,1856,560,1296,91666,10054,28096,2233,7169,70280,2802,3230,38082,4575,446,4129,0,97502,91666,5836,4575,10411,481,0,9930,1998,253,12181,25366
"147",1979,"Iowa",15729,8522,134047,1883,NA,0.1122,10.05,99380,2299,681,1618,93654,11415,18663,2494,8690,66065,3597,4759,44036,5784,854,4930,0,101679,93654,8025,5784,13809,795,0,13014,3115,345,16474,33315
"148",1979,"Jackson",22415,7585,170018,1798,NA,0.1122,10.05,88367,2176,463,1713,89595,9856,18454,2098,6484,75479,3420,3579,45704,3443,416,3027,0,90543,89595,948,3443,4391,184,0,4207,2615,358,7180,12888
"149",1979,"Jasper",36789,9178,337647,1990,NA,0.1122,10.05,124645,3009,754,2255,112467,12934,22740,3660,10984,79764,4341,4617,53191,7173,927,6246,0,127654,112467,15187,7173,22360,1683,0,20677,3424,494,24595,44881
"150",1979,"Jefferson",16259,7849,127622,1262,NA,0.1122,10.05,53918,1567,469,1098,52946,5722,8439,1621,5594,30744,2275,2156,27139,3592,568,3024,0,55485,52946,2539,3592,6131,252,0,5879,1518,192,7589,23174
"151",1979,"Johnson",81406,8880,722918,2273,NA,0.1122,10.05,99659,2524,523,2001,94553,13525,13623,2688,8697,62258,3807,4261,47952,6615,1196,5419,0,102183,94553,7630,6615,14245,802,0,13443,3039,428,16910,37401
"152",1979,"Jones",20368,7636,155538,1888,NA,0.1122,10.05,112344,2302,445,1857,108479,12984,21556,2905,10215,82148,3926,3798,53095,6022,1010,5012,0,114646,108479,6167,6022,12189,899,0,11290,2798,381,14469,30196
"153",1979,"Keokuk",13121,8081,106029,1546,NA,0.1122,10.05,89444,2375,956,1419,89527,12667,10581,2553,10099,56456,4118,2857,46652,6140,1263,4877,0,91819,89527,2292,6140,8432,439,0,7993,2073,289,10355,32988
"154",1979,"Kossuth",21947,8155,178975,2739,NA,0.1122,10.05,186368,4109,1606,2503,183319,18704,29786,5915,17404,92510,7657,6278,97575,12629,1198,11431,0,190477,183319,7158,12629,19787,789,0,18998,4173,511,23682,93858
"155",1979,"Lee",43362,8812,382115,1705,NA,0.1122,10.05,65083,1525,353,1172,58384,8348,9704,1687,5926,38650,2619,2900,27200,4233,558,3675,0,66608,58384,8224,4233,12457,652,0,11805,2234,253,14292,26433
"156",1979,"Linn",167898,10128,1700459,2397,NA,0.1122,10.05,94922,2669,505,2164,102192,8342,12324,3482,10687,45330,4379,4865,58113,6647,582,6065,0,97591,102192,-4601,6647,2046,221,0,1825,3556,505,5886,49592
"157",1979,"Louisa",12103,7810,94520,2026,NA,0.1122,10.05,56860,1581,546,1035,54097,5023,5001,2240,7430,23138,2330,2190,29883,3848,382,3466,0,58441,54097,4344,3848,8192,569,0,7623,1589,215,9427,33722
"158",1979,"Lucas",10428,8011,83539,973,NA,0.1122,10.05,28779,1150,368,782,29082,3943,3784,816,2552,19510,1369,1204,15414,1517,159,1358,0,29929,29082,847,1517,2364,71,0,2293,793,108,3194,9269
"159",1979,"Lyon",12839,8283,106347,2157,NA,0.1122,10.05,141418,2683,809,1874,127632,18257,42109,2769,7442,103510,3802,4333,48920,6646,758,5888,0,144101,127632,16469,6646,23115,788,0,22327,2479,299,25105,37908
"160",1979,"Madison",12875,7998,102972,1368,NA,0.1122,10.05,54011,2019,653,1366,55457,7564,8937,1703,4783,34488,2340,2477,27653,3281,293,2988,0,56030,55457,573,3281,3854,92,0,3762,1564,177,5503,19523
"161",1979,"Mahaska",23021,8508,195871,1636,NA,0.1122,10.05,115656,2186,529,1657,102170,15978,22781,2845,7781,82827,3825,3721,45239,6484,1341,5143,0,117842,102170,15672,6484,22156,874,0,21282,2428,298,24008,32829
"162",1979,"Marion",29190,9101,265663,1662,NA,0.1122,10.05,75264,1974,544,1430,69082,10513,11294,2360,5759,53381,2959,2806,33391,3761,724,3037,0,77238,69082,8156,3761,11917,495,0,11422,1832,250,13504,21883
"163",1979,"Marshall",41662,9539,397415,2160,NA,0.1122,10.05,96754,2555,743,1812,92250,8120,14623,2859,9781,48283,3686,4914,48267,6470,393,6077,0,99309,92250,7059,6470,13529,1575,0,11954,3765,543,16262,48471
"164",1979,"Mills",13631,8343,113723,1674,NA,0.1122,10.05,66662,1497,399,1098,59903,4472,16560,2044,6723,34238,2195,2792,25117,4192,162,4030,0,68159,59903,8256,4192,12448,491,0,11957,1728,212,13897,32424
"165",1979,"Mitchell",12364,7978,98641,2186,90,0.1122,10.05,94532,2282,861,1421,95184,10745,18862,2582,8557,58856,3620,3261,47557,5143,574,4569,0,96814,95184,1630,5143,6773,259,0,6514,2153,259,8926,35676
"166",1979,"Monona",12202,7306,89143,1400,NA,0.1122,10.05,86415,3063,1560,1503,83350,7213,19823,2916,9904,47584,3272,4326,35896,5298,282,5016,0,89478,83350,6128,5298,11426,253,0,11173,2531,266,13970,38831
"167",1979,"Monroe",9616,7279,69996,1038,NA,0.1122,10.05,29933,1127,290,837,31188,3511,6193,859,2756,21470,1379,1211,15279,1568,154,1414,0,31060,31188,-128,1568,1440,NA,0,1419,720,89,2228,8463
"168",1979,"Montgomery",13443,9644,129641,1555,NA,0.1122,10.05,72534,1569,419,1150,58936,6005,15760,2178,5921,40897,2311,2623,24138,4410,339,4071,0,74103,58936,15167,4410,19577,687,0,18890,1820,212,20922,31637
"169",1979,"Muscatine",40494,9247,374451,2224,NA,0.1122,10.05,70380,1433,371,1062,66908,6712,9794,2094,7094,38627,2844,2639,35731,4247,528,3719,0,71813,66908,4905,4247,9152,856,0,8296,2276,332,10904,31753
"170",1979,"O'Brien",17046,8703,148344,2608,NA,0.1122,10.05,170717,2563,701,1862,155795,22402,52923,2881,9606,118778,4047,5455,58481,7264,702,6562,0,173280,155795,17485,7264,24749,1280,0,23469,3667,447,27583,51939
"171",1979,"Osceola",8479,8431,71484,2296,NA,0.1122,10.05,91351,2116,1033,1083,83638,9233,22065,2037,6309,58255,2965,2736,38293,4701,372,4329,0,93467,83638,9829,4701,14530,662,0,13868,1686,194,15748,33096
"172",1979,"Page",19362,8488,164351,1445,NA,0.1122,10.05,91939,2172,665,1507,78706,7530,14898,2637,6193,49570,2598,6612,38238,4641,484,4157,0,94111,78706,15405,4641,20046,933,0,19113,5130,553,24796,42369
"173",1979,"Palo Alto",12936,8089,104635,2420,NA,0.1122,10.05,102385,2497,978,1519,98740,8261,18541,3140,9489,51805,3925,4084,51300,6853,606,6247,0,104882,98740,6142,6853,12995,900,0,12095,2886,385,15366,50580
"174",1979,"Plymouth",24970,8061,201272,2049,NA,0.1122,10.05,190551,3414,839,2575,174792,26178,48188,4011,11437,143022,5706,5908,73364,9796,1506,8290,0,193965,174792,19173,9796,28969,1244,0,27725,3562,463,31750,47529
"175",1979,"Pocahontas",11694,8230,96241,2810,NA,0.1122,10.05,100684,2656,918,1738,93440,8670,18877,3425,9228,46238,3788,3458,45994,7406,501,6905,0,103340,93440,9900,7406,17306,1060,0,16246,2483,351,19080,54446
"176",1979,"Polk",302350,10795,3263858,2334,NA,0.1122,10.05,61051,1804,618,1186,58797,3103,6075,2524,6895,18888,2387,3655,34158,4804,135,4669,0,62855,58797,4058,4804,8862,923,0,7939,3083,433,11455,42163
"177",1979,"Pottawattamie",86463,8531,737587,1647,NA,0.1122,10.05,188945,3591,1179,2412,180523,21028,60114,4622,14952,123686,5814,5884,68109,8528,427,8101,0,192536,180523,12013,8528,20541,935,0,19606,4039,509,24154,65259
"178",1979,"Poweshiek",19061,8666,165174,1888,NA,0.1122,10.05,83725,2332,744,1588,80403,8695,11550,2453,8285,49632,3646,3196,42578,5396,668,4728,0,86057,80403,5654,5396,11050,470,0,10580,2117,275,12972,34093
"179",1979,"Ringgold",6079,7001,42558,955,NA,0.1122,10.05,44860,1374,475,899,45231,4488,7949,1266,4866,30516,2064,1805,22793,2379,154,2225,0,46234,45231,1003,2379,3382,118,0,3264,1121,144,4529,14344
"180",1979,"Sac",14329,9258,132655,2364,NA,0.1122,10.05,145841,2659,1086,1573,130606,17872,37696,3389,9486,100780,4164,4889,53110,7141,755,6386,0,148500,130606,17894,7141,25035,1429,0,23606,3197,414,27217,45061
"181",1979,"Scott",159627,9974,1592061,3091,NA,0.1122,10.05,96488,1438,258,1180,89032,9086,14996,2797,9276,58294,3417,3048,46412,5614,807,4807,0,97926,89032,8894,5614,14508,1740,0,12768,2825,408,16001,38194
"182",1979,"Shelby",14768,8586,126802,1772,NA,0.1122,10.05,116168,2628,923,1705,103517,11327,28916,2781,9085,76523,3907,3653,43848,7281,816,6465,0,118796,103517,15279,7281,22560,979,0,21581,2475,318,24374,39645
"183",1979,"Sioux",30560,8306,253833,2305,NA,0.1122,10.05,349039,4496,1296,3200,321894,53889,135646,4104,11681,300272,6446,8267,101861,9480,1118,8362,0,353535,321894,31641,9480,41121,1895,NA,39225,5236,646,45107,48767
"184",1979,"Story",71442,8040,574395,2613,NA,0.1122,10.05,100451,2842,792,2050,101230,9358,14519,3453,10544,42187,3670,5478,54208,7686,475,7211,0,103293,101230,2063,7686,9749,1164,0,8585,4130,561,13276,58264
"185",1979,"Tama",19897,8151,162183,2116,NA,0.1122,10.05,114829,3337,1010,2327,119670,11838,20372,3817,12192,61944,4667,4748,62036,7583,649,6934,0,118166,119670,-1504,7583,6079,305,0,5774,3328,443,9545,52885
"186",1979,"Taylor",8331,7527,62704,1074,NA,0.1122,10.05,46148,1833,685,1148,42956,4537,5906,1465,3978,26398,2136,2121,22813,2987,269,2718,0,47981,42956,5025,2987,8012,307,0,7705,1141,160,9006,19750
"187",1979,"Union",14083,7678,108126,1200,NA,0.1122,10.05,39997,1522,547,975,40774,5407,7384,1083,3264,27805,1607,1492,20537,1964,140,1824,0,41519,40774,745,1964,2709,113,0,2596,1086,157,3839,12192
"188",1979,"Van Buren",8511,7132,60702,1177,NA,0.1122,10.05,41063,1506,396,1110,40608,4747,4326,1207,4271,24846,1862,1747,22448,2550,366,2184,0,42569,40608,1961,2550,4511,180,0,4331,1178,164,5673,16217
"189",1979,"Wapello",40682,8315,338278,1179,NA,0.1122,10.05,42527,1362,402,960,37402,3083,4681,1447,4929,20923,1861,2033,19368,2976,255,2721,0,43889,37402,6487,2976,9463,516,0,8947,1567,206,10720,21604
"190",1979,"Warren",34253,8736,299251,1621,NA,0.1122,10.05,56788,2045,509,1536,54337,7377,6193,1846,5391,33749,2607,3201,27722,3468,367,3101,0,58833,54337,4496,3468,7964,609,0,7355,2334,318,10007,23039
"191",1979,"Washington",20332,9463,192404,1995,NA,0.1122,10.05,123281,2178,667,1511,103162,19661,15757,2820,9918,82145,4404,4040,46562,7615,1693,5922,0,125459,103162,22297,7615,29912,3792,0,26120,3593,545,30258,41136
"192",1979,"Wayne",8129,7353,59771,970,NA,0.1122,10.05,42193,1395,359,1036,41521,3678,7356,1322,4818,25932,1988,1563,20796,2376,113,2263,0,43588,41521,2067,2376,4443,100,0,4343,823,106,5272,16261
"193",1979,"Webster",45889,9220,423109,2806,NA,0.1122,10.05,117129,2675,689,1986,103779,12378,10995,3869,11140,41681,4214,5862,55321,8937,261,8676,0,119804,103779,16025,8937,24962,1129,0,23833,3771,452,28056,75448
"194",1979,"Winnebago",13522,8106,109609,2493,99,0.1122,10.05,65797,2725,1498,1227,67963,5116,6940,2096,7489,25486,2931,2728,40663,4934,399,4535,0,68522,67963,559,4934,5493,304,0,5189,1493,178,6860,40311
"195",1979,"Winneshiek",22210,6476,143842,1555,NA,0.1122,10.05,115802,3083,624,2459,112028,14840,16967,2691,8043,98023,4809,5308,59370,4515,589,3926,0,118885,112028,6857,4515,11372,333,0,11039,3233,413,14685,17779
"196",1979,"Woodbury",102348,8881,908945,1583,NA,0.1122,10.05,153523,4074,1786,2288,149678,18012,42723,4015,15166,103712,4717,6079,58966,7933,618,7315,0,157597,149678,7919,7933,15852,565,0,15287,3327,420,19034,49811
"197",1979,"Worth",9267,7652,70911,2392,NA,0.1122,10.05,69308,2177,1058,1119,69287,6144,13409,2389,8451,31877,2824,2531,33539,4918,327,4591,0,71485,69287,2198,4918,7116,165,0,6951,1538,189,8678,37431
"198",1979,"Wright",16352,9658,157923,2856,NA,0.1122,10.05,103635,2287,529,1758,90098,8055,11956,3360,10453,35052,3657,3775,48842,8353,482,7871,0,105922,90098,15824,8353,24177,1151,0,23026,2607,328,25961,68583
"199",1980,"Adair",9490,7422,70437,1335,NA,0.1358,11.39,75232,1653,335,1318,74205,8227,13158,2462,8213,47355,4264,2910,34971,-3234,1315,-4549,0,76885,74205,2680,-3234,-554,NA,0,-511,1593,206,1288,27877
"200",1980,"Adams",5713,7445,42531,1312,NA,0.1358,11.39,44482,1233,399,834,44990,5708,7503,1468,4468,29232,2706,1566,21571,-1872,657,-2529,0,45715,44990,725,-1872,-1147,-74,0,-1073,1257,155,339,15250
"201",1980,"Allamakee",15091,7123,107490,1227,NA,0.1358,11.39,70101,1447,140,1307,72922,8445,6814,1687,4891,58856,4407,3031,43647,-2157,1615,-3772,0,71548,72922,-1374,-2157,-3531,-109,0,-3422,2366,265,-791,11245
"202",1980,"Appanoose",15488,7969,123417,906,NA,0.1358,11.39,28966,965,178,787,28665,2304,3075,964,2964,16354,1897,1116,16345,-890,781,-1671,0,29931,28665,1266,-890,376,NA,0,371,767,93,1231,12612
"203",1980,"Audubon",8545,7776,66448,1937,NA,0.1358,11.39,100458,1657,376,1281,97772,12658,23135,2337,8775,70332,4460,3055,43352,-3717,1217,-4934,0,102115,97772,4343,-3717,626,NA,0,621,1890,245,2756,30126
"204",1980,"Benton",23651,9026,213478,2404,NA,0.1358,11.39,146897,2682,478,2204,142636,14036,21573,4604,16549,76285,7307,4974,73593,-7084,1131,-8215,0,149579,142636,6943,-7084,-141,NA,NA,-126,3795,456,4125,70612
"205",1980,"Black Hawk",138013,10376,1432055,2812,124,0.1358,11.39,119397,2130,279,1851,115801,10802,12321,4190,13099,47787,5733,5381,64275,-7077,594,-7671,0,121527,115801,5726,-7077,-1351,-293,0,-1058,4403,533,3878,71610
"206",1980,"Boone",26214,9992,261918,2592,NA,0.1358,11.39,118256,1925,438,1487,96355,9999,13877,3682,11231,48789,4536,4019,49011,-7281,682,-7963,0,120181,96355,23826,-7281,16545,770,0,15775,3285,390,19450,69467
"207",1980,"Bremer",24823,9147,227048,2259,110,0.1358,11.39,87651,1716,161,1555,85414,8786,8685,2778,8865,41263,4671,2856,48773,-5601,599,-6200,0,89367,85414,3953,-5601,-1648,-191,0,-1457,2184,263,990,46388
"208",1980,"Buchanan",22936,8026,184092,2269,115,0.1358,11.39,123580,1792,237,1555,121235,11875,13786,3909,14913,57863,6596,4232,65924,-8171,679,-8850,0,125372,121235,4137,-8171,-4034,-339,0,-3695,2776,320,-599,65717
"209",1980,"Buena Vista",20806,9494,197541,2738,NA,0.1358,11.39,146889,2026,319,1707,134025,19432,23708,3842,12455,75487,6085,5684,62819,-8163,701,-8864,0,148915,134025,14890,-8163,6727,194,NA,6532,3838,487,10857,71402
"210",1980,"Butler",17657,8653,152792,2566,105,0.1358,11.39,125488,2218,542,1676,110446,12181,15269,3646,11761,58260,6098,4096,57395,-8492,583,-9075,0,127706,110446,17260,-8492,8768,268,0,8500,2950,371,11821,67228
"211",1980,"Calhoun",13517,9790,132334,2805,NA,0.1358,11.39,136229,1951,347,1604,104641,12236,23764,3547,10513,58342,4840,3191,46550,-7899,738,-8637,0,138180,104641,33539,-7899,25640,181,0,25459,1764,201,27424,77887
"212",1980,"Carroll",22964,9934,228118,2425,NA,0.1358,11.39,211076,2353,532,1821,183554,30101,67629,3508,10730,161785,6606,5011,59969,-4868,2070,-6938,0,213429,183554,29875,-4868,25007,630,NA,24376,3969,485,28830,49291
"213",1980,"Cass",16965,8826,149729,1731,NA,0.1358,11.39,91581,2150,926,1224,90981,8945,20214,2726,8994,60573,4785,2962,42355,-3569,1271,-4840,0,93731,90981,2750,-3569,-819,-71,0,-748,2143,270,1665,31008
"214",1980,"Cedar",18640,9193,171355,2612,NA,0.1358,11.39,138410,2092,276,1816,136308,13595,19877,4387,15660,72632,6705,4759,71325,-8370,759,-9129,0,140502,136308,4194,-8370,-4176,-738,NA,-3439,3735,463,759,65778
"215",1980,"Cerro Gordo",48472,9767,473431,2735,105,0.1358,11.39,113735,2323,905,1418,111976,9961,10349,3725,14104,38051,6212,4406,63219,-8333,319,-8652,0,116058,111976,4082,-8333,-4251,-647,0,-3604,3355,400,151,75684
"216",1980,"Cherokee",16223,8687,140923,2309,NA,0.1358,11.39,150583,1981,444,1537,143716,15868,39701,3125,9448,100870,5513,3602,66459,-5087,1874,-6961,0,152564,143716,8848,-5087,3761,69,NA,3691,2379,298,6368,49713
"217",1980,"Chickasaw",15422,8595,132552,1876,97,0.1358,11.39,90740,1518,339,1179,84860,8348,10771,2801,10089,50224,5072,2847,44932,-5484,673,-6157,0,92258,84860,7398,-5484,1914,NA,0,1872,2028,241,4141,40516
"218",1980,"Clarke",8623,8006,69036,1059,NA,0.1358,11.39,33900,1090,227,863,34131,3345,4209,1036,3067,22213,2042,1100,19332,-1080,685,-1765,0,34990,34131,859,-1080,-221,NA,0,-208,780,109,681,11687
"219",1980,"Clay",19549,9755,190707,2478,NA,0.1358,11.39,132073,1994,447,1547,112486,11880,23688,3364,10675,61773,5101,4110,53668,-7515,848,-8363,0,134067,112486,21581,-7515,14066,401,0,13665,2882,361,16908,70300
"220",1980,"Clayton",21078,6910,145643,1583,NA,0.1358,11.39,121111,2258,180,2078,125861,16406,13637,3374,10497,96075,7346,4834,69767,-5435,1699,-7134,0,123369,125861,-2492,-5435,-7927,-390,0,-7537,3778,437,-3322,25036
"221",1980,"Clinton",57059,9678,552193,2163,NA,0.1358,11.39,171527,2419,234,2185,162283,15502,35339,4573,17452,99633,7528,5199,76690,-8893,1571,-10464,0,173946,162283,11663,-8893,2770,88,NA,2681,4048,509,7238,71894
"222",1980,"Crawford",18933,7757,146854,2027,NA,0.1358,11.39,123784,3331,1219,2112,129260,16251,27852,3364,10959,86764,5932,4523,60379,-3835,1725,-5560,0,127115,129260,-2145,-3835,-5980,-456,0,-5524,2861,335,-2328,37020
"223",1980,"Dallas",29496,9927,292802,2061,NA,0.1358,11.39,94991,2081,375,1706,95255,5710,13747,3395,10751,36856,4375,3827,53450,-6113,600,-6713,0,97072,95255,1817,-6113,-4296,-591,0,-3705,2754,320,-631,58135
"224",1980,"Davis",9109,7328,66748,1100,NA,0.1358,11.39,44150,1156,205,951,43123,5004,4109,1466,4896,21871,2577,1608,23463,-1842,909,-2751,0,45306,43123,2183,-1842,341,NA,0,337,891,116,1344,22279
"225",1980,"Decatur",9789,6058,59299,837,NA,0.1358,11.39,40113,1186,377,809,42649,3980,7516,1177,4756,25869,2611,1805,20804,-1092,854,-1946,0,41299,42649,-1350,-1092,-2442,-194,0,-2248,1266,162,-820,14244
"226",1980,"Delaware",18925,7189,136053,2347,NA,0.1358,11.39,149261,2121,252,1869,146935,21007,16419,3636,12767,111291,7889,5302,79915,-7535,1057,-8592,0,151382,146935,4447,-7535,-3088,-271,NA,-2818,4060,494,1736,37970
"227",1980,"Des Moines",46208,10025,463217,2007,NA,0.1358,11.39,65305,1151,191,960,54322,4748,5988,2204,7389,22913,3249,2353,28391,-4079,417,-4496,0,66456,54322,12134,-4079,8055,299,0,7756,2137,254,10147,42392
"228",1980,"Dickinson",15624,9428,147307,2139,NA,0.1358,11.39,85586,1199,332,867,77933,9521,20586,2146,6294,43317,3300,2521,33565,-4484,630,-5114,0,86785,77933,8852,-4484,4368,155,0,4213,1966,247,6426,42269
"229",1980,"Dubuque",93701,9222,864110,2175,NA,0.1358,11.39,126045,2021,243,1778,130637,18521,20211,2784,8109,110328,6301,4368,70343,-4739,1673,-6412,0,128066,130637,-2571,-4739,-7310,-207,0,-7103,3462,428,-3213,15717
"230",1980,"Emmet",13329,9905,132021,2486,NA,0.1358,11.39,89587,1220,340,880,70220,4965,12403,2413,7653,31545,3765,2074,36947,-6095,505,-6600,0,90807,70220,20587,-6095,14492,357,0,14135,1541,196,15872,58042
"231",1980,"Fayette",25412,7623,193716,2133,NA,0.1358,11.39,161924,2343,371,1972,157664,18128,22015,4477,15329,91117,8223,6711,82781,-8747,1342,-10089,0,164267,157664,6603,-8747,-2144,-243,NA,-1902,4764,552,3414,70807
"232",1980,"Floyd",19556,8995,175900,2387,98,0.1358,11.39,109634,2255,814,1441,90632,6422,9711,4150,10753,36651,5505,4138,49953,-6757,466,-7223,0,111889,90632,21257,-6757,14500,569,0,13931,3183,377,17491,72983
"233",1980,"Franklin",13016,8715,113429,2788,115,0.1358,11.39,149092,2584,974,1610,135193,14733,21494,4527,14163,66326,6149,5271,68856,-9255,712,-9967,0,151676,135193,16483,-9255,7228,244,NA,6983,3969,477,11429,82766
"234",1980,"Fremont",9376,9759,91505,1835,NA,0.1358,11.39,88622,1671,508,1163,75552,6999,18470,3098,7751,33941,3849,3989,31396,-4324,542,-4866,0,90293,75552,14741,-4324,10417,416,0,10001,3013,352,13366,54681
"235",1980,"Greene",12095,10059,121668,2444,NA,0.1358,11.39,127694,2222,547,1675,102668,10075,18665,3639,11729,47984,4716,4582,49262,-7431,767,-8198,0,129916,102668,27248,-7431,19817,866,0,18951,3411,402,22764,79710
"236",1980,"Grundy",14336,10432,149546,2833,124,0.1358,11.39,143913,2285,436,1849,121838,13460,23978,3528,12422,65573,5130,5227,58093,-7429,679,-8108,0,146198,121838,24360,-7429,16931,1182,NA,15748,4263,547,20558,78340
"237",1980,"Guthrie",11962,7985,95520,1738,NA,0.1358,11.39,79670,1719,402,1317,77978,8612,13243,2246,8043,46722,3970,2785,39079,-3366,1264,-4630,0,81389,77978,3411,-3366,NA,NA,0,44,2025,244,2313,32948
"238",1980,"Hamilton",17865,10299,183990,2900,NA,0.1358,11.39,161203,1870,355,1515,137871,25745,21023,3921,13116,77268,6900,6051,61115,-8824,430,-9254,0,163073,137871,25202,-8824,16378,418,NA,15959,4351,508,20818,83935
"239",1980,"Hancock",13805,9440,130316,2778,122,0.1358,11.39,131093,1922,384,1538,109525,11761,15586,4061,12629,52344,6598,3513,55377,-8600,476,-9076,0,133015,109525,23490,-8600,14890,362,0,14528,2410,294,17232,78749
"240",1980,"Hardin",21763,9674,210540,2688,NA,0.1358,11.39,153835,2747,850,1897,141417,15047,27384,3927,13544,78117,5787,5573,70155,-7702,1037,-8739,0,156582,141417,15165,-7702,7463,315,NA,7147,4216,526,11889,75718
"241",1980,"Harrison",16317,7889,128729,1657,NA,0.1358,11.39,88652,2297,842,1455,77259,5586,9886,3318,11538,35171,4841,3775,38315,-5252,778,-6030,0,90949,77259,13690,-5252,8438,146,0,8292,2591,318,11201,53481
"242",1980,"Henry",18881,8979,169540,1830,NA,0.1358,11.39,81660,1255,178,1077,79446,11569,9189,2393,8434,40939,3828,2572,41461,-4755,427,-5182,0,82915,79446,3469,-4755,-1286,-222,0,-1064,2070,275,1281,40721
"243",1980,"Howard",11097,7786,86401,1645,NA,0.1358,11.39,79366,1640,298,1342,73853,7181,8345,2745,8612,39924,4904,2889,39177,-4750,764,-5514,0,81006,73853,7153,-4750,2403,NA,0,2354,1902,226,4482,39442
"244",1980,"Humboldt",12239,9017,110358,3048,NA,0.1358,11.39,98051,1262,307,955,83523,7656,15404,2974,9528,41017,4241,2414,41306,-6228,349,-6577,0,99313,83523,15790,-6228,9562,173,0,9389,1737,216,11342,57034
"245",1980,"Ida",8908,7419,66084,2278,NA,0.1358,11.39,93012,2487,1349,1138,97000,10788,27026,2500,8184,67967,4090,3077,41335,-2574,1286,-3860,0,95499,97000,-1501,-2574,-4075,-295,0,-3780,1952,233,-1595,25045
"246",1980,"Iowa",15433,8645,133415,1953,NA,0.1358,11.39,111625,1797,361,1436,106745,13573,19337,2938,10714,68223,5218,4348,50617,-5623,1237,-6860,0,113422,106745,6677,-5623,1054,NA,0,1017,2930,328,4275,43402
"247",1980,"Jackson",22472,7943,178490,1912,NA,0.1358,11.39,88976,1723,204,1519,92778,9672,16649,2280,7471,71823,4579,3282,48845,-3490,1550,-5040,0,90699,92778,-2079,-3490,-5569,-383,0,-5186,2787,359,-2040,17153
"248",1980,"Jasper",36366,9875,359113,2060,NA,0.1358,11.39,140970,2325,317,2008,125889,14904,22178,4271,13333,79978,6352,4814,60037,-6683,1111,-7794,0,143295,125889,17406,-6683,10723,370,NA,10352,3792,486,14630,60992
"249",1980,"Jefferson",16278,7966,129675,1303,NA,0.1358,11.39,58084,1227,236,991,58696,6170,8079,1941,6974,29640,3227,2041,30264,-2875,530,-3405,0,59311,58696,615,-2875,-2260,-194,0,-2066,1587,186,-293,28444
"250",1980,"Johnson",82149,9847,808891,2365,NA,0.1358,11.39,107003,2018,248,1770,106342,15844,13031,3139,10909,63972,5420,4217,53782,-5614,881,-6495,0,109021,106342,2679,-5614,-2935,-330,0,-2605,3234,400,1029,43031
"251",1980,"Jones",20365,7670,156193,1985,NA,0.1358,11.39,122617,1947,219,1728,121509,14100,20315,3332,12725,80640,5729,3912,61396,-6186,1154,-7340,0,124564,121509,3055,-6186,-3131,-443,0,-2688,3106,378,796,41977
"252",1980,"Keokuk",12899,8214,105947,1611,NA,0.1358,11.39,104518,1918,646,1272,102243,14487,10598,2971,11931,56905,5721,2763,53772,-5747,759,-6506,0,106436,102243,4193,-5747,-1554,-134,0,-1420,2118,267,965,47613
"253",1980,"Kossuth",21826,8855,193259,2804,NA,0.1358,11.39,235752,3163,947,2216,202616,21217,29050,6804,20633,94738,11222,6216,107474,-14875,940,-15815,0,238915,202616,36299,-14875,21424,449,NA,20973,4406,527,25906,141014
"254",1980,"Lee",43019,9329,401309,1740,NA,0.1358,11.39,67427,1179,153,1026,65048,9199,9594,1965,7322,37904,3718,2732,30518,-3363,580,-3943,0,68606,65048,3558,-3363,195,NA,0,189,2236,242,2667,29523
"255",1980,"Linn",169650,10888,1847192,2492,NA,0.1358,11.39,109549,2159,215,1944,110212,8624,11587,3881,12881,45125,5959,4574,62706,-6858,689,-7547,0,111708,110212,1496,-6858,-5362,-942,0,-4420,3612,455,-353,64424
"256",1980,"Louisa",12078,9013,108863,2108,NA,0.1358,11.39,68433,1258,348,910,59624,5376,4629,2504,8569,23892,3246,2166,33134,-4630,266,-4896,0,69691,59624,10067,-4630,5437,181,0,5256,1645,196,7097,44541
"257",1980,"Lucas",10309,8748,90181,980,NA,0.1358,11.39,33634,881,185,696,32931,4305,3897,932,3090,20559,1990,1081,17636,-1150,668,-1818,0,34515,32931,1584,-1150,434,NA,0,429,688,87,1204,13075
"258",1980,"Lyon",12882,7592,97802,2325,NA,0.1358,11.39,148038,2351,663,1688,137978,20362,40966,3226,8920,98007,5510,4404,54590,-5851,1554,-7405,0,150389,137978,12411,-5851,6560,127,NA,6432,2680,317,9429,50031
"259",1980,"Madison",12583,8817,110948,1482,NA,0.1358,11.39,63365,1482,288,1194,61490,7878,8900,1927,5823,37119,3395,2321,31246,-2894,983,-3877,0,64847,61490,3357,-2894,463,NA,0,458,1532,172,2162,26246
"260",1980,"Mahaska",22817,8717,198895,1689,NA,0.1358,11.39,126159,1817,335,1482,112788,18329,21819,3204,9240,85326,5600,3907,50689,-5271,1040,-6311,0,127976,112788,15188,-5271,9917,176,0,9741,2702,330,12773,40833
"261",1980,"Marion",29715,9579,284644,1695,NA,0.1358,11.39,80483,1513,268,1245,73437,11279,10239,2563,6681,52140,4140,2774,35761,-2866,784,-3650,0,81996,73437,8559,-2866,5693,95,0,5598,1896,244,7738,28343
"262",1980,"Marshall",41706,10476,436902,2232,NA,0.1358,11.39,116841,2101,429,1672,102274,9624,13560,3320,11775,48467,5353,4985,53657,-7352,815,-8167,0,118942,102274,16668,-7352,9316,532,0,8784,4031,508,13323,68374
"263",1980,"Mills",13435,9046,121528,1884,NA,0.1358,11.39,74564,1244,242,1002,64163,5214,15254,2232,8033,33964,3189,2656,27585,-3900,584,-4484,0,75808,64163,11645,-3900,7745,155,0,7590,1649,192,9431,40600
"264",1980,"Mitchell",12291,8071,99200,2319,97,0.1358,11.39,106165,1655,372,1283,104577,12434,17655,3102,9887,58611,5157,3235,53107,-5518,740,-6258,0,107820,104577,3243,-5518,-2275,-153,0,-2122,2186,257,321,47554
"265",1980,"Monona",11662,7547,88010,1560,NA,0.1358,11.39,91627,2697,1368,1329,87312,7494,18407,3266,11721,48488,4562,3804,38058,-4367,886,-5253,0,94324,87312,7012,-4367,2645,NA,0,2615,2311,245,5171,43139
"266",1980,"Monroe",9193,8170,75104,1062,NA,0.1358,11.39,32280,896,144,752,33359,4053,6366,862,2911,21409,1768,1086,16313,-776,822,-1598,0,33176,33359,-183,-776,-959,NA,0,-940,699,82,-159,10871
"267",1980,"Montgomery",13409,9373,125681,1751,NA,0.1358,11.39,70650,1209,181,1028,62457,6110,14280,2341,6868,40212,3400,2486,26972,-2817,793,-3610,0,71859,62457,9402,-2817,6585,109,0,6476,1798,204,8478,30438
"268",1980,"Muscatine",40568,10313,418377,2311,NA,0.1358,11.39,79688,1117,186,931,75769,7598,9659,2440,8897,37921,4164,2917,40094,-4449,465,-4914,0,80805,75769,5036,-4449,587,NA,0,558,2647,336,3541,41767
"269",1980,"O'Brien",16980,8939,151781,2810,NA,0.1358,11.39,184022,2173,462,1711,165423,24823,50116,3450,11373,114440,5754,5063,64844,-7126,1278,-8404,0,186195,165423,20772,-7126,13646,345,NA,13300,3653,428,17381,69582
"270",1980,"Osceola",8350,8669,72386,2475,NA,0.1358,11.39,104795,1881,914,967,92831,10816,21416,2579,7637,54759,4436,2479,43468,-5238,757,-5995,0,106676,92831,13845,-5238,8607,226,0,8381,1742,190,10313,50036
"271",1980,"Page",19041,8535,162514,1626,NA,0.1358,11.39,92537,1695,311,1384,85244,8053,14700,2814,7174,48100,3817,6122,42564,-2970,942,-3912,0,94232,85244,8988,-2970,6018,124,0,5894,4796,537,11227,44437
"272",1980,"Palo Alto",12716,9458,120272,2511,NA,0.1358,11.39,132297,1958,579,1379,108047,9415,17055,3708,11311,49563,5595,4072,56891,-8795,572,-9367,0,134255,108047,26208,-8795,17413,591,0,16822,3043,375,20240,82734
"273",1980,"Plymouth",24781,7537,186765,2254,NA,0.1358,11.39,189587,3055,717,2338,192923,28637,47086,4720,14155,139272,8530,5868,83927,-6511,1916,-8427,0,192642,192923,-281,-6511,-6792,-465,NA,-6328,3604,448,-2276,50315
"274",1980,"Pocahontas",11332,9163,103836,2891,NA,0.1358,11.39,125327,2227,634,1593,102321,9571,18207,4059,11277,45462,5539,3296,50372,-8537,544,-9081,0,127554,102321,25233,-8537,16696,489,0,16207,2503,313,19023,79865
"275",1980,"Polk",303703,11656,3539823,2400,NA,0.1358,11.39,70966,1483,418,1065,63790,3627,5719,2800,8003,17913,3288,3420,36933,-4791,258,-5049,0,72449,63790,8659,-4791,3868,204,0,3664,3084,378,7126,53053
"276",1980,"Pottawattamie",86551,9309,805746,1848,NA,0.1358,11.39,207698,2718,580,2138,192899,21404,57285,5250,18102,121325,8515,5768,76575,-8408,1868,-10276,0,210416,192899,17517,-8408,9109,232,NA,8876,4286,500,13662,86373
"277",1980,"Poweshiek",19307,8863,171123,1959,NA,0.1358,11.39,96128,1695,298,1397,89461,9721,11573,2859,9852,49576,5156,3174,47126,-5284,1073,-6357,0,97823,89461,8362,-5284,3078,61,0,3017,2223,276,5516,46552
"278",1980,"Ringgold",6108,7525,45960,1001,NA,0.1358,11.39,47034,1087,317,770,46173,4651,7022,1302,5263,30879,2767,1598,23570,-896,1093,-1989,0,48121,46173,1948,-896,1052,NA,0,1036,1187,144,2367,16155
"279",1980,"Sac",14103,8687,122514,2543,NA,0.1358,11.39,150694,1903,460,1443,145367,20584,37566,3922,11720,99934,6263,4823,60489,-4982,1411,-6393,0,152597,145367,7230,-4982,2248,62,NA,2185,3446,419,6050,50760
"280",1980,"Scott",160128,10914,1747709,3207,NA,0.1358,11.39,108230,1131,103,1028,101746,11112,14604,3292,11848,53415,4947,3196,52747,-6682,563,-7245,0,109361,101746,7615,-6682,933,52,0,881,3097,392,4370,54815
"281",1980,"Shelby",15008,7903,118603,1980,NA,0.1358,11.39,116087,2367,843,1524,114338,13165,28104,3268,10651,73095,5760,3559,49831,-5408,1323,-6731,0,118454,114338,4116,-5408,-1292,-103,0,-1189,2593,314,1718,42992
"282",1980,"Sioux",30795,8269,254630,2506,NA,0.1358,11.39,361875,3757,828,2929,345508,60189,128053,4773,14174,300011,9480,8290,120549,-7238,3632,-10870,0,365632,345508,20124,-7238,12886,248,NA,12636,5570,681,18887,61864
"283",1980,"Story",72468,8807,638210,2691,NA,0.1358,11.39,128212,2407,562,1845,110461,10430,13567,3941,12471,41066,5240,5543,59269,-8964,381,-9345,0,130619,110461,20158,-8964,11194,645,0,10549,4358,534,15441,87146
"284",1980,"Tama",19504,8842,172453,2192,128,0.1358,11.39,130289,3055,945,2110,126009,12578,17968,4135,13837,59810,6627,4562,66302,-7689,1082,-8771,0,133344,126009,7335,-7689,-354,NA,0,-322,3421,427,3526,70479
"285",1980,"Taylor",8348,7364,61477,1161,NA,0.1358,11.39,48034,1405,394,1011,47052,5099,5482,1604,4671,26926,3061,1969,25166,-1795,818,-2613,0,49439,47052,2387,-1795,592,NA,0,581,1214,152,1947,21108
"286",1980,"Union",13862,8402,116471,1255,NA,0.1358,11.39,42867,1163,290,873,44432,5403,6897,1229,4017,28238,2287,1533,23066,-1170,931,-2101,0,44030,44432,-402,-1170,-1572,-107,0,-1465,1186,153,-126,14629
"287",1980,"Van Buren",8630,7114,61397,1202,NA,0.1358,11.39,41383,1237,264,973,42261,4697,3741,1292,4839,24261,2464,1619,23609,-1769,578,-2347,0,42620,42261,359,-1769,-1410,-101,0,-1309,1269,158,118,17122
"288",1980,"Wapello",40198,9190,369407,1218,NA,0.1358,11.39,47993,1091,239,852,42442,3380,4582,1679,6192,21283,2666,1868,22075,-2486,576,-3062,0,49084,42442,6642,-2486,4156,105,0,4051,1484,178,5713,26710
"289",1980,"Warren",34914,9325,325571,1667,NA,0.1358,11.39,64986,1762,415,1347,61448,7887,5749,2156,6888,35035,3819,3349,31600,-3238,746,-3984,0,66748,61448,5300,-3238,2062,71,0,1991,2523,314,4828,29951
"290",1980,"Washington",20159,9615,193826,2079,NA,0.1358,11.39,136500,1600,278,1322,116233,22511,14742,3316,12355,83737,6402,4041,52866,-7183,630,-7813,0,138100,116233,21867,-7183,14684,844,0,13840,3809,496,18145,52763
"291",1980,"Wayne",8180,7751,63404,976,NA,0.1358,11.39,48127,1135,192,943,45339,4110,6580,1578,5823,25856,2817,1576,22855,-1991,922,-2913,0,49262,45339,3923,-1991,1932,NA,0,1908,917,110,2935,22271
"292",1980,"Webster",45881,10055,461337,2878,NA,0.1358,11.39,148173,2548,713,1835,114359,13822,10638,4313,13724,40612,6035,5788,60039,-10265,440,-10705,0,150721,114359,36362,-10265,26097,587,NA,25509,3995,475,29979,107561
"293",1980,"Winnebago",12951,8373,108439,2574,108,0.1358,11.39,81550,2044,944,1100,74629,5456,6427,2489,9148,24083,4521,2423,44165,-5707,186,-5893,0,83594,74629,8965,-5707,3258,103,0,3155,1540,174,4869,57467
"294",1980,"Winneshiek",21896,6651,145633,1670,NA,0.1358,11.39,115986,2249,234,2015,117364,15637,14664,2958,8757,88721,6788,5051,63509,-5172,1884,-7056,0,118235,117364,871,-5172,-4301,-211,0,-4090,3578,455,-57,27265
"295",1980,"Woodbury",100993,9600,969560,1759,NA,0.1358,11.39,147446,3198,1105,2093,146894,17288,37680,4182,16228,99241,6245,5537,59734,-5227,1948,-7175,0,150644,146894,3750,-5227,-1477,-85,NA,-1393,3396,419,2422,48205
"296",1980,"Worth",9067,7570,68634,2503,NA,0.1358,11.39,79372,1565,543,1022,75894,6531,12397,2775,9855,31004,4178,2498,37660,-5710,217,-5927,0,80937,75894,5043,-5710,-667,NA,0,-635,1613,193,1171,48368
"297",1980,"Wright",16278,10102,164446,2921,NA,0.1358,11.39,124899,2115,538,1577,98916,8822,11889,3845,12199,35530,5215,4024,52922,-8918,301,-9219,0,127014,98916,28098,-8918,19180,502,0,18678,2944,360,21982,89369
"298",1981,"Adair",9396,9298,87361,1367,NA,0.1035,14.04,79176,1997,560,1437,75202,8343,10712,2669,8551,49510,4828,2947,37152,2389,-2750,5139,0,81173,75202,5971,2389,8360,299,0,8061,1601,179,9841,29666
"299",1981,"Adams",5631,9272,52210,1372,NA,0.1035,14.04,49454,1256,346,910,47922,5879,6418,1656,4849,31647,3114,1737,24269,1942,-1473,3415,0,50710,47922,2788,1942,4730,166,0,4564,1341,150,6055,17807
"300",1981,"Allamakee",14988,8486,127185,1300,NA,0.1035,14.04,88391,1531,116,1415,83666,9664,6041,2159,5731,75715,5793,3444,50834,-120,-3502,3382,0,89922,83666,6256,-120,6136,101,0,6035,2210,252,8497,12676
"301",1981,"Appanoose",15362,8679,133333,1007,NA,0.1035,14.04,26052,1103,281,822,27800,2030,2005,922,2853,16055,1883,1040,17067,225,-1557,1782,0,27155,27800,-645,225,-420,NA,0,-399,755,78,434,9997
"302",1981,"Audubon",8467,9732,82399,1965,NA,0.1035,14.04,106930,1855,455,1400,100095,13843,18536,2622,9312,74253,5196,3363,47223,2524,-2581,5105,0,108785,100095,8690,2524,11214,155,0,11059,2006,246,13311,32677
"303",1981,"Benton",23603,10488,247546,2479,NA,0.1035,14.04,154746,3236,819,2417,145782,14577,16474,5022,17663,79897,8165,4792,79089,5715,-2497,8212,0,157982,145782,12200,5715,17915,1087,0,16828,3815,415,21058,74849
"304",1981,"Black Hawk",137897,11411,1573545,2918,112,0.1035,14.04,114965,2777,759,2018,118147,10976,9660,4547,13415,52041,6285,5186,68078,5799,-1172,6971,0,117742,118147,-405,5799,5394,624,0,4770,4314,463,9547,62924
"305",1981,"Boone",26276,11067,290804,2685,121,0.1035,14.04,117658,2022,422,1600,100898,10365,11494,4174,12338,50867,5283,4148,53096,5797,-1268,7065,0,119680,100898,18782,5797,24579,2362,0,22217,3370,347,25934,66791
"306",1981,"Bremer",24782,10351,256518,2463,120,0.1035,14.04,92221,1770,61,1709,92462,9992,7749,3246,9838,53482,5524,2976,53137,4376,-1229,5605,0,93991,92462,1529,4376,5905,368,0,5537,2256,234,8027,38739
"307",1981,"Buchanan",23032,9265,213392,2479,127,0.1035,14.04,121552,2503,850,1653,122200,12031,10585,4041,14813,64305,6856,3790,70084,6350,-1377,7727,0,124055,122200,1855,6350,8205,384,0,7821,2753,304,10878,57247
"308",1981,"Buena Vista",20890,10989,229553,2773,NA,0.1035,14.04,147331,2278,416,1862,136341,20338,19463,4279,13183,81813,6738,5851,66489,7108,-1256,8364,0,149609,136341,13268,7108,20376,1168,0,19208,4058,469,23735,65518
"309",1981,"Butler",17573,9696,170381,2680,116,0.1035,14.04,121101,2375,537,1838,115456,13094,12387,4092,12395,66619,6840,3990,62658,6459,-1173,7632,0,123476,115456,8020,6459,14479,885,0,13594,2973,330,16897,54482
"310",1981,"Calhoun",13385,11293,151154,2833,124,0.1035,14.04,131607,2715,968,1747,110223,14627,20480,3998,11719,61360,5784,3318,50297,6516,-1473,7989,0,134322,110223,24099,6516,30615,474,0,30141,1703,192,32036,70247
"311",1981,"Carroll",22964,11629,267046,2450,106,0.1035,14.04,216128,2810,788,2022,177320,29946,55717,3719,10717,164124,7393,4849,64979,2853,-4495,7348,0,218938,177320,41618,2853,44471,2192,NA,42280,3927,431,46638,52004
"312",1981,"Cass",17060,10785,183996,1751,NA,0.1035,14.04,99119,2370,1041,1329,90564,9054,16087,2964,9396,59748,5285,2874,44904,3271,-2510,5781,0,101489,90564,10925,3271,14196,580,0,13616,2083,235,15934,39371
"313",1981,"Cedar",18618,11008,204940,2792,NA,0.1035,14.04,143723,2507,550,1957,138506,13624,15144,4864,16267,76692,7408,4847,76352,6948,-1467,8415,0,146230,138506,7724,6948,14672,1408,0,13264,3878,421,17563,67031
"314",1981,"Cerro Gordo",48416,11002,532692,2857,118,0.1035,14.04,111815,2466,903,1563,115619,10546,7816,4120,14536,43011,6867,4214,67520,7072,-665,7737,0,114281,115619,-1338,7072,5734,438,0,5296,3151,338,8785,68804
"315",1981,"Cherokee",16128,10351,166945,2280,NA,0.1035,14.04,151568,2306,602,1704,141523,16225,32066,3341,9417,101700,5925,3486,71063,2864,-3980,6844,0,153874,141523,12351,2864,15215,498,0,14717,2369,274,17360,49868
"316",1981,"Chickasaw",15327,9916,151978,2042,105,0.1035,14.04,94252,2200,927,1273,90222,9149,8656,3098,10696,56769,5833,2990,49800,4153,-1416,5569,0,96452,90222,6230,4153,10383,501,0,9882,2130,241,12253,37483
"317",1981,"Clarke",8646,8804,76118,1114,NA,0.1035,14.04,32545,1235,291,944,33554,3050,2880,1092,3124,21540,2249,1113,20046,849,-1417,2266,0,33780,33554,226,849,1075,NA,0,1047,795,89,1931,11005
"318",1981,"Clay",19398,10700,207553,2519,NA,0.1035,14.04,125863,2191,499,1692,114141,12604,18797,3726,11369,67879,5741,4039,57865,5957,-1716,7673,0,128054,114141,13913,5957,19870,1133,0,18737,2900,321,21958,57984
"319",1981,"Clayton",20951,8628,180765,1659,NA,0.1035,14.04,149435,2478,264,2214,141730,19579,11344,4143,12240,121969,9110,5182,80132,2233,-3771,6004,0,151913,141730,10183,2233,12416,294,0,12122,3540,403,16065,27466
"320",1981,"Clinton",56676,10846,614735,2331,NA,0.1035,14.04,172032,2717,291,2426,162155,15247,26263,5014,18580,100349,8301,5388,83362,5747,-3405,9152,0,174749,162155,12594,5747,18341,1100,0,17241,4276,477,21994,71683
"321",1981,"Crawford",18884,10166,191984,2041,NA,0.1035,14.04,142337,4370,2052,2318,127768,15813,21737,3522,11157,93470,6660,4104,64775,2261,-3771,6032,0,146707,127768,18939,2261,21200,848,0,20352,2673,295,23320,48867
"322",1981,"Dallas",29362,11672,342709,2087,104,0.1035,14.04,103972,2295,440,1855,97576,5504,11139,3730,11013,38713,4832,3599,57759,6403,-1161,7564,0,106267,97576,8691,6403,15094,1183,0,13911,2712,287,16910,65259
"323",1981,"Davis",9109,8166,74385,1202,NA,0.1035,14.04,40837,1349,326,1023,42155,5031,2990,1466,4740,24675,2635,1478,23815,968,-1567,2535,0,42186,42155,NA,968,999,NA,0,978,892,100,1970,16162
"324",1981,"Decatur",9748,7100,69213,922,NA,0.1035,14.04,41581,1436,553,883,41846,3826,5890,1151,4544,27514,2678,1771,21986,499,-1920,2419,0,43017,41846,1171,499,1670,73,0,1597,1278,144,3019,14067
"325",1981,"Delaware",18853,9086,171303,2565,NA,0.1035,14.04,174909,2526,485,2041,163756,23967,13846,4296,14362,136678,9567,5808,91910,4863,-2284,7147,0,177435,163756,13679,4863,18542,783,0,17759,3995,466,22220,38231
"326",1981,"Des Moines",46125,10994,507121,2095,NA,0.1035,14.04,65237,1371,339,1032,55123,5058,4511,2421,7478,23219,3555,2331,29769,3702,-817,4519,0,66608,55123,11485,3702,15187,1107,0,14080,2282,234,16596,42018
"327",1981,"Dickinson",15567,10778,167780,2225,NA,0.1035,14.04,82508,1107,232,875,78319,10801,16340,2356,6712,45329,3631,2512,35967,3506,-1320,4826,0,83615,78319,5296,3506,8802,580,0,8222,2011,226,10459,37179
"328",1981,"Dubuque",93307,10187,950547,2285,NA,0.1035,14.04,153586,2352,371,1981,144607,21170,17095,3250,9033,136754,7651,5214,81194,1099,-3621,4720,0,155938,144607,11331,1099,12430,181,0,12249,3655,440,16344,16832
"329",1981,"Emmet",13270,10740,142525,2551,NA,0.1035,14.04,79097,1403,437,966,69993,4752,9367,2697,7894,31612,4123,1952,39208,4717,-1094,5811,0,80500,69993,10507,4717,15224,686,0,14538,1453,163,16154,47485
"330",1981,"Fayette",25052,8910,223215,2304,NA,0.1035,14.04,162660,3110,967,2143,164336,18942,17709,4964,15958,109988,9283,6616,90864,5226,-2972,8198,0,165770,164336,1434,5226,6660,421,0,6239,4679,523,11441,52672
"331",1981,"Floyd",19345,9904,191587,2527,104,0.1035,14.04,99425,2093,492,1601,94621,6515,8107,4019,11379,40852,6096,4139,54366,5268,-965,6233,0,101518,94621,6897,5268,12165,1027,0,11138,3333,364,14835,58573
"332",1981,"Franklin",12904,10333,133338,2837,126,0.1035,14.04,144332,2822,1035,1787,138202,15651,17456,4879,14422,72445,6844,5116,73834,7043,-1333,8376,0,147154,138202,8952,7043,15995,1073,0,14922,4020,445,19387,71887
"333",1981,"Fremont",9254,10998,101774,1793,NA,0.1035,14.04,77973,1782,525,1257,73543,7343,14770,3059,7745,34060,4049,3510,33067,4404,-1171,5575,0,79755,73543,6212,4404,10616,776,0,9840,2726,303,12869,43913
"334",1981,"Greene",11976,11463,137276,2479,117,0.1035,14.04,122306,2410,617,1793,104397,10461,14239,4185,12382,49044,5387,4450,53293,6361,-1650,8011,0,124716,104397,20319,6361,26680,2286,0,24394,3249,342,27985,73262
"335",1981,"Grundy",14187,12053,170999,2947,133,0.1035,14.04,137039,2498,499,1999,120621,13698,18125,3764,12683,68369,5653,5121,61577,6125,-1320,7445,0,139537,120621,18916,6125,25041,3473,0,21568,4314,476,26358,68670
"336",1981,"Guthrie",11855,9921,117614,1763,97,0.1035,14.04,85762,1971,530,1441,79869,9096,10973,2355,8539,49081,4367,2702,41837,2700,-2590,5290,0,87733,79869,7864,2700,10564,336,0,10228,1951,222,12401,36681
"337",1981,"Hamilton",17836,12034,214638,3013,121,0.1035,14.04,163848,2044,418,1626,145728,28413,18087,4322,13943,88307,7827,6117,67019,8239,-754,8993,0,165892,145728,20164,8239,28403,1523,0,26880,4213,477,31570,75541
"338",1981,"Hancock",13663,11507,157214,2865,126,0.1035,14.04,129368,2235,562,1673,110109,12272,11718,4405,12705,59975,7346,3386,58277,7544,-1000,8544,0,131603,110109,21494,7544,29038,1372,0,27666,2402,265,30333,69393
"339",1981,"Hardin",21661,11040,239145,2775,117,0.1035,14.04,149603,2534,478,2056,144773,15313,22114,4426,14317,83443,6535,6005,76063,5742,-2166,7908,0,152137,144773,7364,5742,13106,1129,0,11977,4586,504,17067,66160
"340",1981,"Harrison",16157,9847,159104,1694,NA,0.1035,14.04,96818,2353,763,1590,78648,5570,7980,3648,12027,37586,5358,3750,40315,4533,-1697,6230,0,99171,78648,20523,4533,25056,883,0,24173,2665,310,27148,59232
"341",1981,"Henry",18805,10207,191935,1947,NA,0.1035,14.04,81691,1398,224,1174,80712,12424,7251,2641,8778,42844,4102,2399,43117,4374,-712,5086,0,83089,80712,2377,4374,6751,555,0,6196,2025,219,8440,38847
"342",1981,"Howard",11004,9295,102287,1796,NA,0.1035,14.04,79964,2171,684,1487,75837,7582,6653,3015,8592,46610,5545,2937,41513,3305,-1640,4945,0,82135,75837,6298,3305,9603,386,0,9217,1970,223,11410,33354
"343",1981,"Humboldt",12186,11062,134800,3069,123,0.1035,14.04,98944,1390,370,1020,84189,7698,11754,3279,10119,41005,4727,2433,44179,6139,-688,6827,0,100334,84189,16145,6139,22284,746,0,21538,1768,203,23509,57939
"344",1981,"Ida",8890,10020,89081,2262,NA,0.1035,14.04,99693,2191,973,1218,93198,10663,21245,2640,8093,65479,4533,2817,43207,2288,-2625,4913,0,101884,93198,8686,2288,10974,364,0,10610,1831,202,12643,34214
"345",1981,"Iowa",15415,10045,154836,2018,NA,0.1035,14.04,116023,1989,440,1549,110672,14727,16288,3241,11347,74811,5758,4066,55245,3766,-2685,6451,0,118012,110672,7340,3766,11106,897,0,10209,2603,290,13102,41212
"346",1981,"Jackson",22297,9229,205768,2041,NA,0.1035,14.04,100566,1863,219,1644,96875,9645,13437,2540,8061,78645,5097,3524,54571,1378,-3198,4576,0,102429,96875,5554,1378,6932,227,0,6705,2809,332,9846,21921
"347",1981,"Jasper",36047,11362,409565,2171,111,0.1035,14.04,152312,3025,858,2167,128733,15745,17673,4676,13938,91057,7054,4986,64661,5351,-2458,7809,0,155337,128733,26604,5351,31955,2051,0,29904,4021,445,34370,61255
"348",1981,"Jefferson",16093,9223,148431,1420,NA,0.1035,14.04,61284,1417,335,1082,59071,6111,6304,2168,7434,31853,3489,1906,31659,2622,-1097,3719,0,62701,59071,3630,2622,6252,309,0,5943,1605,170,7718,29431
"349",1981,"Johnson",83689,10935,915147,2539,NA,0.1035,14.04,116939,2374,470,1904,110091,16979,10185,3440,11719,72312,5897,4221,57650,4756,-1731,6487,0,119313,110091,9222,4756,13978,878,0,13100,3347,351,16798,44627
"350",1981,"Jones",20178,9022,182042,2116,NA,0.1035,14.04,127832,2137,212,1925,124719,14101,15639,3595,13593,84737,6350,4147,67294,4215,-2377,6592,0,129969,124719,5250,4215,9465,733,0,8732,3312,353,12397,43095
"351",1981,"Keokuk",12780,9671,123599,1740,NA,0.1035,14.04,105534,1954,569,1385,105819,15026,8558,3208,12037,61361,6027,2659,58304,4722,-1361,6083,0,107488,105819,1669,4722,6391,267,0,6124,2088,230,8442,44173
"352",1981,"Kossuth",21515,10389,223520,2852,NA,0.1035,14.04,224947,3191,808,2383,208131,22602,23667,7535,21600,103576,12747,6235,113745,12452,-1960,14412,0,228138,208131,20007,12452,32459,1403,NA,31057,4416,498,35971,121371
"353",1981,"Lee",42572,10537,448595,1831,NA,0.1035,14.04,71164,1358,260,1098,66378,9328,7745,2148,7769,40056,4037,2628,32723,2659,-1188,3847,0,72522,66378,6144,2659,8803,595,0,8208,2156,223,10587,31108
"354",1981,"Linn",168753,11923,2012056,2710,NA,0.1035,14.04,116342,2443,321,2122,115806,8793,9470,4338,14192,51608,6644,4645,67724,6068,-1494,7562,0,118785,115806,2979,6068,9047,758,0,8289,3565,383,12237,64734
"355",1981,"Louisa",12144,10366,125884,2293,NA,0.1035,14.04,64447,1711,740,971,60804,5299,3497,2639,8556,25060,3471,2134,35208,4448,-559,5007,0,66158,60804,5354,4448,9802,627,0,9175,1660,172,11007,39387
"356",1981,"Lucas",10271,9761,100253,1061,NA,0.1035,14.04,30618,1079,323,756,31928,3956,2985,915,2946,21323,2007,903,18216,531,-1391,1922,0,31697,31928,-231,531,300,NA,0,294,568,62,924,9295
"357",1981,"Lyon",12796,9704,124169,2316,NA,0.1035,14.04,154344,2386,546,1840,135011,20889,32565,3528,9224,109438,6075,4431,58299,3031,-3371,6402,0,156730,135011,21719,3031,24750,1040,0,23710,2752,306,26768,44906
"358",1981,"Madison",12502,9880,123526,1559,95,0.1035,14.04,60213,1670,394,1276,61353,7404,7093,2016,5985,36628,3669,2055,33131,1995,-2029,4024,0,61883,61353,530,1995,2525,62,0,2463,1430,155,4048,23585
"359",1981,"Mahaska",22565,10182,229767,1797,NA,0.1035,14.04,133667,2028,422,1606,113837,19287,17078,3401,9477,94443,6221,4076,54297,3641,-2196,5837,0,135695,113837,21858,3641,25499,829,0,24670,2819,327,27816,39224
"360",1981,"Marion",29831,11028,328970,1790,NA,0.1035,14.04,83770,1708,381,1327,72160,11145,7559,2631,6706,56034,4447,2687,36985,2510,-1664,4174,0,85478,72160,13318,2510,15828,427,0,15401,1867,219,17487,27736
"361",1981,"Marshall",41826,11612,485693,2329,125,0.1035,14.04,112057,2139,288,1851,104602,10414,10263,3620,12223,49626,5911,5036,57135,5244,-1685,6929,0,114196,104602,9594,5244,14838,1663,0,13175,4176,450,17801,62431
"362",1981,"Mills",13520,10209,138031,1881,NA,0.1035,14.04,68946,1431,335,1096,62762,5564,11460,2300,8285,32904,3521,2536,29096,3749,-1254,5003,0,70377,62762,7615,3749,11364,458,0,10906,1513,160,12579,36042
"363",1981,"Mitchell",12113,9761,118236,2449,107,0.1035,14.04,104879,2588,1189,1399,105582,13186,13493,3478,9889,64186,5614,3180,56742,3735,-1404,5139,0,107467,105582,1885,3735,5620,192,0,5428,2112,237,7777,40693
"364",1981,"Monona",11517,10715,123399,1605,NA,0.1035,14.04,106245,2520,1098,1422,83768,7163,13951,3449,11985,48755,4886,3309,39025,4339,-1956,6295,0,108765,83768,24997,4339,29336,666,0,28670,1983,213,30866,57490
"365",1981,"Monroe",9111,8833,80482,1146,NA,0.1035,14.04,29637,1126,306,820,32620,4248,5242,812,2647,21989,1750,987,16934,NA,-1671,1633,0,30763,32620,-1857,NA,-1895,NA,0,-1870,657,72,-1141,7648
"366",1981,"Montgomery",13362,10777,143999,1724,NA,0.1035,14.04,71943,1377,263,1114,60561,5707,10535,2377,6896,40616,3790,2425,28831,2470,-1775,4245,0,73320,60561,12759,2470,15229,477,0,14752,1698,185,16635,31327
"367",1981,"Muscatine",41000,11687,479180,2528,NA,0.1035,14.04,79249,1213,215,998,78621,7903,7779,2668,9556,40536,4625,3096,42994,3825,-991,4816,0,80462,78621,1841,3825,5666,585,0,5081,2928,317,8326,38713
"368",1981,"O'Brien",16973,10494,178113,2863,NA,0.1035,14.04,177008,2290,399,1891,159381,25310,38773,3857,11633,118464,6255,4643,68910,4992,-2717,7709,0,179298,159381,19917,4992,24909,1231,0,23678,3487,380,27545,58544
"369",1981,"Osceola",8253,10022,82710,2493,NA,0.1035,14.04,99811,1527,479,1048,93752,11588,16984,3009,7966,57016,5005,2191,47009,3539,-1647,5186,0,101338,93752,7586,3539,11125,642,0,10483,1742,178,12403,42795
"370",1981,"Page",18915,9743,184295,1595,NA,0.1035,14.04,89156,2163,638,1525,84182,7933,11843,2839,7193,50057,4250,5434,44690,2676,-2129,4805,0,91319,84182,7137,2676,9813,364,0,9449,4194,481,14124,39099
"371",1981,"Palo Alto",12673,10499,133050,2514,NA,0.1035,14.04,119105,2124,616,1508,108849,9851,12794,4100,11638,51928,6093,3909,60464,7290,-1090,8380,0,121229,108849,12380,7290,19670,1309,0,18361,3083,338,21782,67177
"372",1981,"Plymouth",24879,9630,239590,2218,NA,0.1035,14.04,210027,3189,627,2562,193448,28845,37591,5204,15040,148163,9619,5853,91296,4437,-4090,8527,0,213216,193448,19768,4437,24205,774,0,23431,3465,402,27298,61864
"373",1981,"Pocahontas",11160,11459,127879,2905,130,0.1035,14.04,124387,1985,231,1754,102726,9723,14352,4501,11858,48856,6149,3124,53019,7959,-1072,9031,0,126372,102726,23646,7959,31605,1780,0,29825,2452,263,32540,75531
"374",1981,"Polk",304865,12714,3875990,2473,112,0.1035,14.04,68382,1790,628,1162,64375,3879,4399,2932,8040,19807,3486,3160,38479,5259,-567,5826,0,70172,64375,5797,5259,11056,1173,0,9883,3019,313,13215,48575
"375",1981,"Pottawattamie",86312,10444,901440,1872,NA,0.1035,14.04,208062,3189,885,2304,186318,20001,44607,5613,18880,121910,9462,5518,82237,5904,-3951,9855,0,211251,186318,24933,5904,30837,1690,0,29147,4387,460,33994,86152
"376",1981,"Poweshiek",19267,10396,200295,2033,123,0.1035,14.04,98958,1896,400,1496,91455,9994,9461,3126,10117,52112,5580,3164,50013,3704,-2265,5969,0,100854,91455,9399,3704,13103,487,0,12616,2215,255,15086,46846
"377",1981,"Ringgold",6082,8520,51820,1075,NA,0.1035,14.04,45826,1790,980,810,46094,4758,5403,1353,5265,30499,3030,1531,24754,762,-2312,3074,0,47616,46094,1522,762,2284,64,0,2220,1201,134,3555,15327
"378",1981,"Sac",14012,11195,156862,2564,NA,0.1035,14.04,167040,2271,680,1591,146376,21738,30556,4266,12436,110026,7091,4707,65582,4060,-3102,7162,0,169311,146376,22935,4060,26995,1445,0,25550,3548,392,29490,57014
"379",1981,"Scott",160177,11986,1919815,3484,NA,0.1035,14.04,108931,1323,228,1095,106461,12331,11621,3631,12912,57842,5451,3414,57101,5039,-1171,6210,0,110254,106461,3793,5039,8832,918,0,7914,3273,354,11541,51089
"380",1981,"Shelby",14832,10199,151269,1937,NA,0.1035,14.04,125964,2337,685,1652,114467,14012,22319,3598,10798,75334,6431,3366,53943,3941,-2688,6629,0,128301,114467,13834,3941,17775,749,0,17026,2607,286,19919,50630
"381",1981,"Sioux",30654,9782,299845,2470,NA,0.1035,14.04,363908,3941,727,3214,333678,61824,98749,5210,14813,305924,10567,8222,134293,2069,-7562,9631,0,367849,333678,34171,2069,36240,1183,NA,35058,5570,654,41282,57984
"382",1981,"Story",72864,9698,706668,2788,117,0.1035,14.04,119898,2569,565,2004,111597,10692,10351,4234,12746,44840,5714,5558,62302,7098,-762,7860,0,122467,111597,10870,7098,17968,2010,0,15958,4440,478,20876,75058
"383",1981,"Tama",19342,10459,202296,2266,134,0.1035,14.04,127251,3247,942,2305,125493,12689,13252,4341,13953,63404,7339,4540,69379,6046,-2256,8302,0,130498,125493,5005,6046,11051,509,0,10542,3360,382,14284,63847
"384",1981,"Taylor",8315,8542,71028,1203,NA,0.1035,14.04,47310,1990,909,1081,47368,5268,4153,1660,4743,27847,3346,1935,26263,1953,-1739,3692,0,49300,47368,1932,1953,3885,136,0,3749,1248,135,5132,19463
"385",1981,"Union",13848,9418,130426,1304,NA,0.1035,14.04,41478,1390,443,947,43611,4822,5129,1283,4143,27354,2425,1677,24132,574,-1995,2569,0,42868,43611,-743,574,-169,NA,0,-160,1238,139,1217,14124
"386",1981,"Van Buren",8627,8152,70331,1300,NA,0.1035,14.04,45453,1421,383,1038,45455,5040,3088,1524,5529,26133,2933,1787,25554,1344,-1170,2514,0,46874,45455,1419,1344,2763,101,0,2662,1322,141,4125,19320
"387",1981,"Wapello",39936,9759,389743,1309,NA,0.1035,14.04,46463,1132,209,923,43888,3412,3663,1830,6661,22842,2915,1711,23696,2130,-1158,3288,0,47595,43888,3707,2130,5837,276,0,5561,1359,142,7062,23621
"388",1981,"Warren",34977,10185,356247,1820,90,0.1035,14.04,64072,1899,453,1446,63985,7767,4355,2362,7509,37946,4244,3464,34284,2729,-1646,4375,0,65971,63985,1986,2729,4715,297,0,4418,2614,289,7321,26126
"389",1981,"Washington",20184,11459,231290,2251,NA,0.1035,14.04,146913,1950,539,1411,120129,23648,11262,3653,13199,97455,7075,4101,57191,5842,-1132,6974,0,148863,120129,28734,5842,34576,3648,0,30928,3938,424,35290,49458
"390",1981,"Wayne",8090,8959,72477,1079,NA,0.1035,14.04,45052,1430,394,1036,45428,4223,4783,1761,6064,25697,3054,1593,23950,1245,-1996,3241,0,46482,45428,1054,1245,2299,60,0,2239,974,105,3318,19355
"391",1981,"Webster",45488,10960,498554,2969,117,0.1035,14.04,136370,2757,722,2035,120810,14978,8875,4790,15329,43739,6954,5940,63944,9764,-574,10338,0,139127,120810,18317,9764,28081,1253,0,26828,4008,456,31292,92631
"392",1981,"Winnebago",12684,9870,125190,2619,118,0.1035,14.04,75251,2153,963,1190,76193,5360,4856,2765,9614,26101,5208,2210,46180,5226,-374,5600,0,77404,76193,1211,5226,6437,441,0,5996,1531,160,7687,49150
"393",1981,"Winneshiek",21927,8081,177197,1803,NA,0.1035,14.04,134728,2436,398,2038,128662,17497,11925,3502,9503,112748,8284,5629,72322,1415,-3964,5379,0,137164,128662,8502,1415,9917,237,0,9680,3682,448,13810,21980
"394",1981,"Woodbury",101193,10938,1106870,1802,NA,0.1035,14.04,160789,5785,3482,2303,145938,16987,30038,4557,16684,97119,7045,5522,65105,4147,-4082,8229,0,166574,145938,20636,4147,24783,685,0,24098,3283,385,27766,63670
"395",1981,"Worth",9014,9362,84386,2590,NA,0.1035,14.04,76727,1936,814,1122,76265,6394,9350,3026,9941,33207,4678,2475,40401,4286,-379,4665,0,78663,76265,2398,4286,6684,180,0,6504,1601,185,8290,43520
"396",1981,"Wright",16079,11612,186708,3072,123,0.1035,14.04,120430,2347,641,1706,104688,9534,10340,4440,13198,38182,6082,4469,56625,8590,-581,9171,0,122777,104688,18089,8590,26679,1490,0,25189,3131,355,28675,82248
"397",1982,"Adair",9258,9544,88361,1176,NA,0.0616,10.6,71760,6064,2145,3919,76367,8310,12546,2548,7579,51582,4620,3001,37763,1497,-4483,5980,0,77824,76367,1457,1497,2954,74,0,2880,1707,161,4748,20178
"398",1982,"Adams",5556,9841,54677,1156,NA,0.0616,10.6,48421,3290,946,2344,50394,5816,7752,1611,4393,36281,2991,1855,25976,1307,-2601,3908,0,51711,50394,1317,1307,2624,74,0,2550,1484,150,4184,12140
"399",1982,"Allamakee",14870,8839,131436,1143,NA,0.0616,10.6,88114,4674,1012,3662,87948,9402,6708,2093,4957,79242,5514,3375,55899,-3442,-4990,1548,0,92788,87948,4840,-3442,1398,NA,0,1380,2214,242,3836,8872
"400",1982,"Appanoose",15157,9151,138699,891,NA,0.0616,10.6,23745,2170,613,1557,27180,1909,2018,847,2552,16775,1750,1043,17061,2098,-2165,4263,0,25915,27180,-1265,2098,833,NA,0,814,757,66,1637,6970
"401",1982,"Audubon",8356,9311,77799,1608,NA,0.0616,10.6,95561,5393,1296,4097,101216,13727,19916,2400,7815,73275,4744,3520,49094,344,-4274,4618,0,100954,101216,-262,344,82,NA,0,81,2313,249,2643,22286
"402",1982,"Benton",23301,10625,247584,2101,NA,0.0616,10.6,134895,10674,3581,7093,147448,14843,18104,4824,15992,84284,7741,4739,81205,7714,-4382,12096,0,145569,147448,-1879,7714,5835,274,NA,5560,4032,387,9979,50611
"403",1982,"Black Hawk",136836,11652,1594403,2432,131,0.0616,10.6,102040,9345,3483,5862,117963,10951,10909,4347,11717,57978,5874,5206,68959,5123,-2811,7934,0,111385,117963,-6578,5123,-1455,-375,0,-1080,4446,415,3781,44062
"404",1982,"Boone",26058,11440,298112,2272,120,0.0616,10.6,97620,6623,2221,4402,100156,9588,12455,3796,10511,51339,4790,4110,54906,8541,-2506,11047,0,104243,100156,4087,8541,12628,977,0,11651,3629,315,15595,46281
"405",1982,"Bremer",24661,10549,260145,2078,125,0.0616,10.6,81516,7316,2699,4617,92673,9803,8794,2950,8217,55217,4893,2784,55232,3209,-2289,5498,0,88832,92673,-3841,3209,-632,-89,0,-543,2373,215,2045,26299
"406",1982,"Buchanan",22976,9320,214130,2091,134,0.0616,10.6,113918,7183,3105,4078,124040,12729,12495,3922,13367,75183,6496,3787,71244,876,-4038,4914,0,121101,124040,-2939,876,-2063,-224,0,-1839,2941,290,1392,38735
"407",1982,"Buena Vista",20854,10784,224899,2257,NA,0.0616,10.6,137504,7453,1939,5514,139891,20855,22969,4180,11849,93232,6345,6372,67321,6944,-3900,10844,0,144957,139891,5066,6944,12010,538,NA,11471,4667,464,16602,44272
"408",1982,"Butler",17431,9739,169764,2217,123,0.0616,10.6,112044,7653,2816,4837,119141,13743,14459,4023,11102,75089,6500,4068,65246,4892,-3414,8306,0,119697,119141,556,4892,5448,261,0,5187,3175,303,8665,36955
"409",1982,"Calhoun",13243,10819,143275,2366,120,0.0616,10.6,108980,7435,2366,5069,111386,15092,22511,3527,9868,61545,5226,3266,51896,8811,-2777,11588,0,116415,111386,5029,8811,13840,180,0,13660,1797,182,15639,47435
"410",1982,"Carroll",22665,11566,262147,2014,117,0.0616,10.6,194002,7923,2111,5812,187037,29271,65972,3479,9149,158465,7015,4900,67251,2105,-6929,9034,0,201925,187037,14888,2105,16993,647,NA,16344,4113,395,20852,35537
"411",1982,"Cass",16918,10892,184276,1463,NA,0.0616,10.6,87536,4931,1553,3378,92064,9001,18437,2837,8354,60851,4965,2924,45546,2036,-3893,5929,0,92467,92064,403,2036,2439,69,0,2370,2190,213,4773,26685
"412",1982,"Cedar",18516,11054,204670,2425,NA,0.0616,10.6,125786,8341,2732,5609,139300,13413,16603,4735,14388,80458,6963,5080,78118,887,-4112,4999,0,134127,139300,-5173,887,-4286,-934,0,-3352,4243,391,1282,45328
"413",1982,"Cerro Gordo",48220,11343,546957,2342,123,0.0616,10.6,95015,9744,5224,4520,115800,10925,8487,4001,12769,48641,6454,4239,68925,7209,-2214,9423,0,104759,115800,-11041,7209,-3832,-626,0,-3206,3137,293,224,46374
"414",1982,"Cherokee",15869,10434,165574,1862,NA,0.0616,10.6,143056,7171,2358,4813,146430,16288,37275,3154,8024,108888,5452,3594,72643,2304,-6315,8619,0,150227,146430,3797,2304,6101,142,NA,5958,2557,257,8772,34168
"415",1982,"Chickasaw",15211,9741,148164,1725,99,0.0616,10.6,86423,5922,2960,2962,94000,9803,10092,3026,9677,60981,5667,3185,52550,2110,-2914,5024,0,92345,94000,-1655,2110,455,NA,0,436,2387,239,3062,25442
"416",1982,"Clarke",8723,9417,82143,977,NA,0.0616,10.6,29279,3336,900,2436,31758,2579,2662,965,2579,21698,1994,1072,19907,1478,-1998,3476,0,32615,31758,857,1478,2335,NA,0,2294,834,78,3206,7581
"417",1982,"Clay",19220,10694,205535,2051,NA,0.0616,10.6,110047,7045,1943,5102,117711,13079,21479,3624,10275,70829,5470,4177,59607,6800,-3130,9930,0,117092,117711,-619,6800,6181,277,0,5904,3117,295,9316,39218
"418",1982,"Clayton",20801,8652,179976,1458,NA,0.0616,10.6,148886,7446,1604,5842,149104,20684,12362,4059,11021,129919,8677,5152,87149,-6217,-6953,736,0,156332,149104,7228,-6217,1011,NA,NA,993,3559,381,4933,18967
"419",1982,"Clinton",56359,10817,609658,2050,NA,0.0616,10.6,146167,9261,2090,7171,164384,14736,28020,4838,16789,97495,7790,5740,86471,-1104,-5299,4195,0,155428,164384,-8956,-1104,-10060,-1290,NA,-8771,4763,459,-3549,48672
"420",1982,"Crawford",18842,9973,187914,1663,NA,0.0616,10.6,123478,9415,2617,6798,129134,15115,24433,3258,9694,90168,6333,3892,66409,4061,-6081,10142,0,132893,129134,3759,4061,7820,242,0,7578,2668,267,10513,33310
"421",1982,"Dallas",29174,12239,357047,1757,NA,0.0616,10.6,88054,7299,1867,5432,99085,5211,12988,3605,9625,43818,4541,3531,59584,8740,-2214,10954,0,95353,99085,-3732,8740,5008,322,0,4686,2851,261,7798,44236
"422",1982,"Davis",9025,8874,80085,1035,NA,0.0616,10.6,37214,3453,1087,2366,40811,5142,3275,1344,4071,26100,2389,1449,23141,1655,-2430,4085,0,40667,40811,-144,1655,1511,NA,0,1489,943,94,2526,11114
"423",1982,"Decatur",9583,7758,74342,817,NA,0.0616,10.6,38053,3194,1027,2167,42353,3812,6999,1052,3908,28368,2477,1867,22238,1593,-2349,3942,0,41247,42353,-1106,1593,487,NA,0,470,1381,131,1982,9685
"424",1982,"Delaware",18718,8970,167895,2234,NA,0.0616,10.6,173280,7828,2147,5681,172666,24875,15692,4156,12803,147190,9127,5965,100048,-6448,-7057,609,0,181108,172666,8442,-6448,1994,60,NA,1932,4205,451,6588,26090
"425",1982,"Des Moines",45420,11355,515731,1763,NA,0.0616,10.6,52771,4528,1834,2694,54507,5266,4883,2337,6463,24237,3316,2372,29870,2840,-1618,4458,0,57299,54507,2792,2840,5632,318,0,5314,2495,222,8031,28534
"426",1982,"Dickinson",15384,11235,172844,1823,NA,0.0616,10.6,75837,3697,1389,2308,81763,11846,18680,2276,6073,50375,3402,2650,36836,3495,-2528,6023,0,79534,81763,-2229,3495,1266,62,0,1204,2207,215,3626,25462
"427",1982,"Dubuque",91992,10465,962657,2008,NA,0.0616,10.6,156717,6440,1466,4974,155514,22516,19895,3185,8163,144768,7464,5647,88644,-6715,-7070,355,0,163157,155514,7643,-6715,928,NA,NA,917,4046,457,5420,11949
"428",1982,"Emmet",13143,10162,133564,2076,NA,0.0616,10.6,65070,4924,2290,2634,69795,4465,10176,2642,6937,33069,3848,1938,39789,5429,-2065,7494,0,69994,69795,199,5429,5628,185,0,5443,1454,139,7036,32001
"429",1982,"Fayette",24837,9017,223957,1984,NA,0.0616,10.6,154832,8524,2801,5723,169530,19393,20504,4831,14141,118960,8867,6702,95092,503,-5579,6082,0,163356,169530,-6174,503,-5671,-833,NA,-4839,4935,501,597,35872
"430",1982,"Floyd",19103,10402,198707,2093,118,0.0616,10.6,88638,7245,2640,4605,96426,6488,9713,3437,10225,43501,5743,4368,56452,6095,-2101,8196,0,95883,96426,-543,6095,5552,389,0,5163,3718,354,9235,45137
"431",1982,"Franklin",12787,10037,128338,2308,135,0.0616,10.6,127424,9889,4651,5238,141237,16260,20396,4636,12535,78888,6468,5280,75662,5884,-3387,9271,0,137313,141237,-3924,5884,1960,103,NA,1856,4378,423,6657,48536
"432",1982,"Fremont",9166,11160,102294,1522,NA,0.0616,10.6,65593,5771,1994,3777,74095,7544,17005,2672,6614,35444,3659,3281,33320,7860,-1757,9617,0,71364,74095,-2731,7860,5129,273,0,4856,2693,265,7814,30149
"433",1982,"Greene",11790,11380,134166,2077,110,0.0616,10.6,96885,8221,2755,5466,101399,9616,13924,3830,10080,47377,4767,4132,55050,9028,-2721,11749,0,105106,101399,3707,9028,12735,844,0,11891,3293,295,15479,49508
"434",1982,"Grundy",13947,11998,167331,2477,139,0.0616,10.6,117506,9109,2904,6205,121091,13687,19701,3542,11049,70761,5305,5357,62450,6215,-2920,9135,0,126615,121091,5524,6215,11739,1274,0,10465,4630,429,15524,46745
"435",1982,"Guthrie",11687,10259,119894,1455,NA,0.0616,10.6,75919,5573,1717,3856,81958,9404,13060,2180,7698,50755,4092,2706,42818,4132,-3472,7604,0,81492,81958,-466,4132,3666,83,0,3583,2039,208,5830,25164
"436",1982,"Hamilton",17590,12106,212946,2505,128,0.0616,10.6,146756,7336,2859,4477,150400,29330,21378,4016,12087,95834,7251,6263,70075,10073,-2615,12688,0,154092,150400,3692,10073,13765,601,NA,13163,4471,451,18085,50922
"437",1982,"Hancock",13583,11682,158675,2326,129,0.0616,10.6,111714,7840,3156,4684,109368,12548,12661,4211,10919,64820,6943,3396,58690,7361,-2942,10303,0,119554,109368,10186,7361,17547,637,0,16910,2556,246,19712,46894
"438",1982,"Hardin",21547,11111,239404,2306,NA,0.0616,10.6,133356,9938,3632,6306,149772,15301,25703,4368,12854,87839,6245,6573,78728,3771,-4138,7909,0,143294,149772,-6478,3771,-2707,-532,NA,-2176,5248,497,3569,45517
"439",1982,"Harrison",16034,10017,160607,1399,NA,0.0616,10.6,77853,6813,2521,4292,78548,5459,9274,3527,10670,37757,5043,3989,40586,7673,-2435,10108,0,84666,78548,6118,7673,13791,387,0,13404,2986,303,16693,40096
"440",1982,"Henry",18689,10602,198144,1638,NA,0.0616,10.6,71801,4486,1493,2993,79155,12530,7924,2461,7474,45524,3612,2215,42939,2037,-2463,4500,0,76287,79155,-2868,2037,-831,-138,0,-693,2046,182,1535,26277
"441",1982,"Howard",10907,9253,100926,1517,NA,0.0616,10.6,70955,7013,2813,4200,76126,7837,7638,2911,7328,48317,5302,3030,42080,2997,-2780,5777,0,77968,76126,1842,2997,4839,150,0,4689,2173,221,7083,22638
"442",1982,"Humboldt",11971,11197,134043,2509,130,0.0616,10.6,82941,4438,1878,2560,85011,7602,12907,3178,9121,43889,4474,2563,45166,8571,-1833,10404,0,87379,85011,2368,8571,10939,270,0,10669,1928,195,12792,39052
"443",1982,"Ida",8744,9884,86426,1842,NA,0.0616,10.6,89130,4673,1310,3363,93986,10355,24051,2463,6843,65863,4270,2766,43238,1313,-4168,5481,0,93803,93986,-183,1313,1130,NA,0,1105,1851,179,3135,23267
"444",1982,"Iowa",15155,10332,156575,1684,NA,0.0616,10.6,110798,6718,2510,4208,115419,15579,19672,3142,10208,82786,5409,3867,57542,-1968,-4929,2961,0,117516,115419,2097,-1968,129,NA,0,120,2513,258,2891,28012
"445",1982,"Jackson",22075,9385,207177,1795,NA,0.0616,10.6,98511,5268,1202,4066,102251,9652,15994,2526,7505,83365,4902,3665,58007,-4202,-4684,482,0,103779,102251,1528,-4202,-2674,-178,0,-2496,2919,321,744,15146
"446",1982,"Jasper",35708,11702,417871,1816,NA,0.0616,10.6,138514,8091,2166,5925,132049,16282,20277,4503,12399,96851,6653,5393,66542,2866,-4721,7587,0,146605,132049,14556,2866,17422,827,NA,16594,4500,417,21511,41663
"447",1982,"Jefferson",16315,9015,147079,1195,NA,0.0616,10.6,52330,4174,1437,2737,57815,5755,6857,2052,6501,32423,3121,1823,31706,2774,-2276,5050,0,56504,57815,-1311,2774,1463,60,0,1403,1716,153,3272,19907
"448",1982,"Johnson",84633,11603,981958,2148,NA,0.0616,10.6,110830,6849,1873,4976,112146,17776,11465,3316,10666,80553,5476,4387,59060,-1073,-4634,3561,0,117679,112146,5533,-1073,4460,228,0,4232,3611,317,8160,30277
"449",1982,"Jones",20019,9018,180529,1860,NA,0.0616,10.6,119048,7200,1635,5565,127589,13854,17331,3416,12313,89779,5981,4365,70329,-2108,-4781,2673,0,126248,127589,-1341,-2108,-3449,-611,0,-2838,3598,337,1097,29269
"450",1982,"Keokuk",12639,10455,132138,1438,NA,0.0616,10.6,102588,6767,3363,3404,107467,15394,10029,3072,10445,72343,5494,2669,60364,1291,-4765,6056,0,109355,107467,1888,1291,3179,96,0,3083,2163,205,5451,30245
"451",1982,"Kossuth",21203,10435,221246,2296,126,0.0616,10.6,192421,12481,6312,6169,208108,22641,26644,7052,18501,108766,11808,6272,115190,16428,-4608,21036,0,204902,208108,-3206,16428,13222,460,NA,12760,4761,481,18002,83655
"452",1982,"Lee",42265,10881,459900,1577,NA,0.0616,10.6,65803,3247,807,2440,67199,9292,9001,2065,7001,44605,3742,2554,33544,4070,-2824,6894,0,69050,67199,1851,4070,5921,338,0,5583,2163,205,7951,21198
"453",1982,"Linn",167054,12602,2105225,2351,NA,0.0616,10.6,102183,6958,1674,5284,116443,8416,10685,4083,12680,56881,6055,4676,69848,6454,-2927,9381,0,109141,116443,-7302,6454,-848,-144,0,-704,3703,337,3336,45302
"454",1982,"Louisa",12006,10840,130144,1942,NA,0.0616,10.6,56078,5893,3232,2661,59825,5130,3798,2456,7303,27705,3180,2191,35767,3520,-1504,5024,0,61971,59825,2146,3520,5666,276,0,5390,1743,153,7286,28373
"455",1982,"Lucas",10276,10256,105388,939,NA,0.0616,10.6,27943,2236,641,1595,31577,3871,3555,856,2590,21532,1867,816,18022,642,-1904,2546,0,30179,31577,-1398,642,-756,NA,0,-731,471,44,-216,6411
"456",1982,"Lyon",12703,10311,130986,1897,NA,0.0616,10.6,150990,6654,1660,4994,139681,21028,37279,3392,8127,120523,5703,4614,59538,4144,-5879,10023,0,157644,139681,17963,4144,22107,775,NA,21331,3021,299,24651,30467
"457",1982,"Madison",12470,10675,133119,1333,93,0.0616,10.6,57549,4168,1172,2996,61213,6888,8204,1872,5271,41443,3407,1960,33611,2473,-3507,5980,0,61717,61213,504,2473,2977,59,0,2918,1453,142,4513,16106
"458",1982,"Mahaska",22279,10588,235880,1512,NA,0.0616,10.6,125066,5769,1569,4200,116507,19873,19250,3186,8290,98442,5873,4441,55594,1736,-5318,7054,0,130835,116507,14328,1736,16064,381,0,15683,3218,326,19227,26624
"459",1982,"Marion",29923,11692,349855,1545,NA,0.0616,10.6,78710,4406,1370,3036,70467,10818,8002,2390,5751,58032,4091,2770,36645,1840,-3548,5388,0,83116,70467,12649,1840,14489,251,0,14238,2010,205,16453,20678
"460",1982,"Marshall",41824,12025,502921,1957,NA,0.0616,10.6,95649,7310,1822,5488,105480,10994,11169,3474,10806,52466,5553,5315,58169,4081,-2787,6868,0,102959,105480,-2521,4081,1560,136,0,1424,4533,411,6368,43183
"461",1982,"Mills",13379,10994,147088,1598,NA,0.0616,10.6,60190,5016,1777,3239,62730,5803,12373,2100,7282,35832,3309,2508,29355,5118,-2038,7156,0,65206,62730,2476,5118,7594,242,0,7352,1485,138,8975,24358
"462",1982,"Mitchell",11943,10294,122947,2028,110,0.0616,10.6,98417,6522,2640,3882,106825,13679,14842,3417,8454,70572,5218,3254,57961,3399,-3309,6708,0,104939,106825,-1886,3399,1513,NA,0,1474,2204,223,3901,27845
"463",1982,"Monona",11402,10727,122314,1302,NA,0.0616,10.6,85519,6824,2739,4085,81344,6718,15205,3215,10456,46662,4481,2964,38305,6885,-2715,9600,0,92343,81344,10999,6885,17884,322,0,17562,1841,185,19588,38857
"464",1982,"Monroe",8949,9617,86063,982,NA,0.0616,10.6,30879,2696,773,1923,33110,4501,6438,705,2142,25553,1548,939,16837,152,-2605,2757,0,33575,33110,465,152,617,NA,0,614,646,62,1322,5326
"465",1982,"Montgomery",13146,11302,148580,1464,NA,0.0616,10.6,62631,4268,1089,3179,59878,5218,11144,2136,5914,41625,3587,2410,29469,3769,-2769,6538,0,66899,59878,7021,3769,10790,255,0,10535,1725,171,12431,21006
"466",1982,"Muscatine",41404,12260,507623,2183,NA,0.0616,10.6,72397,3369,1249,2120,80226,8058,9018,2565,8696,44967,4363,3469,44057,1354,-2232,3586,0,75766,80226,-4460,1354,-3106,-744,0,-2362,3355,307,1300,27430
"467",1982,"O'Brien",16859,11047,186239,2345,NA,0.0616,10.6,170180,7223,1864,5359,162796,25334,43195,3782,10148,130526,5808,4482,70047,5782,-5155,10937,0,177403,162796,14607,5782,20389,778,NA,19610,3597,345,23552,39654
"468",1982,"Osceola",8123,9575,77780,2042,NA,0.0616,10.6,86143,5093,2353,2740,97019,12131,19399,3052,7069,57063,4780,2038,48550,5949,-2679,8628,0,91236,97019,-5783,5949,166,NA,0,158,1831,166,2155,29080
"469",1982,"Page",18606,10326,192130,1355,NA,0.0616,10.6,78134,5527,1225,4302,83228,7465,13360,2466,5989,49519,3903,5147,44898,4163,-3391,7554,0,83661,83228,433,4163,4596,122,0,4474,4171,433,9078,28615
"470",1982,"Palo Alto",12505,10311,128942,2033,NA,0.0616,10.6,100742,7291,2961,4330,109229,10096,13794,3984,10207,55441,5663,4042,61443,8758,-2678,11436,0,108033,109229,-1196,8758,7562,390,0,7172,3338,312,10822,45301
"471",1982,"Plymouth",24431,10045,245399,1806,NA,0.0616,10.6,200295,8706,1630,7076,200329,28541,43209,5044,13566,158344,9181,5980,94808,3004,-8305,11309,0,209001,200329,8672,3004,11676,259,NA,11415,3585,371,15371,41951
"472",1982,"Pocahontas",10969,11156,122372,2364,120,0.0616,10.6,104468,7894,2661,5233,103235,9700,16289,4383,10598,53444,5801,3074,53390,10085,-2637,12722,0,112362,103235,9127,10085,19212,824,0,18388,2507,230,21125,51024
"473",1982,"Polk",304567,13616,4146956,2097,NA,0.0616,10.6,54912,4996,2365,2631,63103,4053,4873,2712,6897,20679,3170,3040,38358,7645,-949,8594,0,59908,63103,-3195,7645,4450,373,0,4077,3045,266,7388,34233
"474",1982,"Pottawattamie",85934,10926,938895,1568,NA,0.0616,10.6,183700,9186,3177,6009,189348,18303,50023,5297,16764,124291,8931,5616,84414,7537,-5760,13297,0,192886,189348,3538,7537,11075,504,NA,10569,4744,429,15742,59409
"475",1982,"Poweshiek",19096,10893,208016,1695,NA,0.0616,10.6,89263,5932,1975,3957,92265,10082,11124,3010,8857,57428,5163,3260,50769,2143,-4218,6361,0,95195,92265,2930,2143,5073,141,0,4932,2372,245,7549,31835
"476",1982,"Ringgold",6104,9449,57676,937,NA,0.0616,10.6,42511,2801,1020,1781,45340,4672,5890,1216,4410,31880,2764,1493,24895,3214,-3358,6572,0,45312,45340,NA,3214,3186,64,0,3122,1289,127,4538,10631
"477",1982,"Sac",13740,10713,147194,2107,NA,0.0616,10.6,150565,6599,2141,4458,153031,22467,35755,4085,11204,111865,6789,4838,67893,4671,-5242,9913,0,157164,153031,4133,4671,8804,362,NA,8441,3897,376,12714,38700
"478",1982,"Scott",159622,12397,1978896,3064,NA,0.0616,10.6,100225,3249,932,2317,109801,13291,13313,3520,11890,64408,5111,3651,59025,-1326,-2942,1616,0,103474,109801,-6327,-1326,-7653,-1696,0,-5957,3533,332,-2092,35817
"479",1982,"Shelby",14780,10241,151355,1595,NA,0.0616,10.6,116065,6652,2343,4309,118203,14582,25523,3482,9344,81717,6092,3411,55769,1135,-5260,6395,0,122717,118203,4514,1135,5649,185,0,5464,2819,267,8550,34348
"480",1982,"Sioux",30534,9480,289477,2018,NA,0.0616,10.6,347578,11423,2012,9411,351178,62309,109644,5007,13174,307989,9994,8605,142445,-2016,-11591,9575,0,359001,351178,7823,-2016,5807,128,NA,5677,6088,627,12392,39589
"481",1982,"Story",72292,10416,753024,2355,NA,0.0616,10.6,102475,9154,3159,5995,111056,10757,11366,4012,11114,51049,5314,5846,62647,10054,-1991,12045,0,111629,111056,573,10054,10627,912,0,9715,4796,437,14948,51426
"482",1982,"Tama",19204,10882,208974,1903,137,0.0616,10.6,111312,9670,2955,6715,122921,12377,13887,3964,11831,68023,6782,4590,69490,4550,-4281,8831,0,120982,122921,-1939,4550,2611,92,0,2519,3561,350,6430,43289
"483",1982,"Taylor",8311,9440,78457,1037,NA,0.0616,10.6,43429,4123,1417,2706,46203,5199,4408,1477,4000,30156,3033,1838,26248,3556,-2703,6259,0,47552,46203,1349,3556,4905,130,0,4775,1332,124,6231,13273
"484",1982,"Union",13749,10503,144406,1138,NA,0.0616,10.6,39827,3579,1155,2424,42601,4209,5501,1182,3636,30254,2201,1701,24171,319,-2963,3282,0,43406,42601,805,319,1124,NA,0,1098,1284,134,2516,9573
"485",1982,"Van Buren",8522,8538,72760,1117,NA,0.0616,10.6,39735,3469,941,2528,44085,4482,3109,1335,4535,26628,2504,1714,26406,2489,-2019,4508,0,43204,44085,-881,2489,1608,NA,0,1563,1435,129,3127,13107
"486",1982,"Wapello",39385,10376,408674,1101,NA,0.0616,10.6,40332,3202,1275,1927,43705,3319,4140,1722,5955,24099,2664,1597,24308,2612,-1930,4542,0,43534,43705,-171,2612,2441,86,0,2355,1309,118,3782,16233
"487",1982,"Warren",34727,10781,374380,1584,NA,0.0616,10.6,62050,4485,1240,3245,64684,7514,4744,2274,6914,44032,4006,3714,35518,1953,-3029,4982,0,66535,64684,1851,1953,3804,174,0,3630,2841,272,6743,18018
"488",1982,"Washington",20064,12061,242000,1860,NA,0.0616,10.6,144329,6418,3037,3381,122274,24330,12382,3539,11960,110769,6650,4299,59114,891,-4852,5743,0,150747,122274,28473,891,29364,2267,NA,27096,4210,378,31684,33560
"489",1982,"Wayne",7958,9542,75939,955,NA,0.0616,10.6,38835,3794,1093,2701,44598,4204,4909,1703,5303,27474,2790,1649,24040,2624,-2747,5371,0,42629,44598,-1969,2624,655,NA,0,641,1102,102,1845,11361
"490",1982,"Webster",44908,11212,503516,2470,124,0.0616,10.6,110038,9414,3481,5933,120258,14860,9953,4378,13563,47129,6384,6016,65104,15185,-1698,16883,0,119452,120258,-806,15185,14379,501,0,13878,4373,442,18693,62909
"491",1982,"Winnebago",12548,10403,130540,2126,123,0.0616,10.6,62468,7206,3901,3305,74996,5174,5276,2696,8590,29264,5049,2010,46201,5688,-1231,6919,0,69674,74996,-5322,5688,366,NA,0,345,1581,149,2075,33204
"492",1982,"Winneshiek",21817,8468,184746,1553,NA,0.0616,10.6,131556,6752,1832,4920,135118,18067,13225,3431,8303,116088,8005,5985,78102,-3442,-6225,2783,0,138308,135118,3190,-3442,-252,NA,NA,-241,4094,449,4302,15468
"493",1982,"Woodbury",100548,11370,1143276,1463,NA,0.0616,10.6,144456,10877,4276,6601,150583,16421,34678,4405,14731,100995,6803,5831,67714,-323,-6489,6166,0,155333,150583,4750,-323,4427,87,NA,4339,3511,359,8209,43461
"494",1982,"Worth",8951,9571,85666,2124,110,0.0616,10.6,64630,6177,3051,3126,76136,6146,10139,2906,8564,35261,4443,2533,41405,5923,-1148,7071,0,70807,76136,-5329,5923,594,NA,0,581,1724,177,2482,29369
"495",1982,"Wright",15844,12107,191829,2511,130,0.0616,10.6,97893,8338,3140,5198,104649,9261,11843,4133,11154,42423,5542,4820,57896,12417,-1793,14210,0,106231,104649,1582,12417,13999,644,0,13355,3609,355,17319,55470
"496",1983,"Adair",9210,9056,83409,1035,NA,0.0322,8.62,72333,11658,8048,3610,72091,8584,9160,2204,6022,41807,4215,2988,38918,-19804,-2352,-17452,0,83991,72091,11900,-19804,-7904,-1108,0,-6796,1603,147,-5046,30526
"497",1983,"Adams",5494,9490,52138,1047,NA,0.0322,8.62,45807,6119,4091,2028,45819,5552,5471,1346,3442,31077,2746,1843,25419,-9905,-1242,-8663,0,51926,45819,6107,-9905,-3798,-518,0,-3280,1315,132,-1833,14730
"498",1983,"Allamakee",14889,8592,127924,1062,NA,0.0322,8.62,84988,7149,4008,3141,83483,10003,5280,1714,3885,74282,4992,3446,54163,-21061,-2907,-18154,0,92137,83483,8654,-21061,-12407,-795,0,-11612,2158,230,-9224,10706
"499",1983,"Appanoose",14864,9298,138205,747,NA,0.0322,8.62,20533,3969,2635,1334,26916,1993,1759,719,2060,14881,1653,1064,17668,-3612,-1562,-2050,0,24502,26916,-2414,-3612,-6026,-651,0,-5375,693,63,-4619,5652
"500",1983,"Audubon",8243,8824,72735,1525,NA,0.0322,8.62,94760,11400,7726,3674,91345,13645,14713,2018,6082,61191,4350,3439,47098,-24445,-1733,-22712,0,106160,91345,14815,-24445,-9630,-427,0,-9203,2129,223,-6851,33569
"501",1983,"Benton",22905,10816,247734,1988,NA,0.0322,8.62,148990,21291,15124,6167,138408,15224,15331,3991,12331,77472,7109,4950,79472,-35037,-1645,-33392,0,170281,138408,31873,-35037,-3164,-735,NA,-2428,3759,354,1685,71518
"502",1983,"Black Hawk",135579,11840,1605211,2280,135,0.0322,8.62,120506,15899,10634,5265,109510,11816,8425,3530,9044,53257,5391,5318,65986,-34759,-793,-33966,0,136405,109510,26895,-34759,-7864,-3416,0,-4448,4075,376,3,67249
"503",1983,"Boone",25897,11917,308618,2159,117,0.0322,8.62,118243,14785,11075,3710,92880,9492,9473,3177,8240,46070,4451,4177,53870,-29657,-783,-28874,0,133028,92880,40148,-29657,10491,-861,0,11352,3415,293,15060,72173
"504",1983,"Bremer",24533,10735,263351,1934,129,0.0322,8.62,87626,11643,7718,3925,86673,10120,6721,2508,6556,50389,4508,2928,53332,-24180,-786,-23394,0,99269,86673,12596,-24180,-11584,-2626,0,-8958,2113,195,-6650,37237
"505",1983,"Buchanan",22739,8998,204597,1949,129,0.0322,8.62,118031,14846,11304,3542,115686,13257,9876,3324,10453,65055,6017,3969,68790,-38407,-898,-37509,0,132877,115686,17191,-38407,-21216,-3994,0,-17222,2820,273,-14129,52976
"506",1983,"Buena Vista",20749,10847,225074,2202,NA,0.0322,8.62,137120,15271,10546,4725,130927,22575,17598,3430,9065,82891,5824,6383,66052,-26582,-923,-25659,0,152391,130927,21464,-26582,-5118,-1116,NA,-4001,4432,424,855,54229
"507",1983,"Butler",17254,9865,170211,2083,133,0.0322,8.62,121151,18294,14086,4208,111737,14634,11405,3326,8776,68680,5924,4278,63394,-32545,-755,-31790,0,139445,111737,27708,-32545,-4837,-1139,0,-3698,2962,279,-457,52471
"508",1983,"Calhoun",13015,11243,146329,2266,110,0.0322,8.62,125388,15991,11646,4345,101797,14726,16224,2956,7758,54047,4785,3348,52000,-32073,-902,-31171,0,141379,101797,39582,-32073,7509,-123,0,7632,1857,180,9669,71341
"509",1983,"Carroll",22638,11695,264750,1962,102,0.0322,8.62,188537,14360,9202,5158,165935,29368,47853,2940,7286,136636,6472,5087,66929,-30055,-3048,-27007,0,202897,165935,36962,-30055,6907,-262,NA,7170,3887,364,11421,51901
"510",1983,"Cass",16882,11155,188311,1341,NA,0.0322,8.62,94206,12593,9586,3007,85028,9145,14058,2413,6504,54885,4560,3001,45347,-24941,-2029,-22912,0,106799,85028,21771,-24941,-3170,-434,0,-2736,2025,194,-517,39321
"511",1983,"Cedar",18576,10893,202344,2273,NA,0.0322,8.62,123777,14863,9877,4986,127788,13873,13004,3857,10970,70744,6289,4925,74870,-30346,-866,-29480,0,138640,127788,10852,-30346,-19494,-7040,0,-12454,3718,336,-8400,53033
"512",1983,"Cerro Gordo",48061,11886,571277,2203,117,0.0322,8.62,118467,19451,15590,3861,105667,10990,6024,3272,9683,47950,5942,4326,65430,-36607,-210,-36397,0,137918,105667,32251,-36607,-4356,-1237,0,-3119,2910,265,56,70517
"513",1983,"Cherokee",15848,10204,161720,1813,NA,0.0322,8.62,138864,13372,9150,4222,131160,16356,27403,2683,6413,93566,5043,3857,69405,-26456,-3280,-23176,0,152236,131160,21076,-26456,-5380,-651,NA,-4728,2475,242,-2011,45298
"514",1983,"Chickasaw",15147,9804,148497,1605,113,0.0322,8.62,91082,12821,9946,2875,88489,10138,8361,2604,7653,54786,5207,3282,51244,-24306,-943,-23363,0,103903,88489,15414,-24306,-8892,-1737,0,-7155,2259,223,-4673,36296
"515",1983,"Clarke",8568,9347,80086,831,85,0.0322,8.62,25539,5367,3303,2064,30564,2777,2038,858,2138,18957,1892,1073,19788,-4482,-1164,-3318,0,30906,30564,342,-4482,-4140,-351,0,-3789,733,68,-2988,6582
"516",1983,"Clay",19203,10702,205512,2002,NA,0.0322,8.62,113625,15807,11425,4382,106359,13215,16037,2982,7866,61759,4982,4074,57203,-23244,-1248,-21996,0,129432,106359,23073,-23244,-171,NA,0,-133,2825,262,2954,51866
"517",1983,"Clayton",20602,8231,169572,1355,NA,0.0322,8.62,146693,12763,7241,5522,142816,21725,9789,3362,8600,121475,7932,5333,86075,-38763,-2879,-35884,0,159456,142816,16640,-38763,-22123,-1974,NA,-20148,3421,354,-16373,25218
"518",1983,"Clinton",55329,10975,607243,1909,NA,0.0322,8.62,142173,15923,9725,6198,146929,14633,20563,3986,12821,83356,7058,5673,82195,-41017,-2259,-38758,0,158096,146929,11167,-41017,-29850,-6835,NA,-23014,4266,403,-18345,58817
"519",1983,"Crawford",18812,9591,180420,1601,NA,0.0322,8.62,119579,17612,11850,5762,119473,15440,18660,2793,7638,73625,5836,4097,65009,-30309,-2708,-27601,0,137191,119473,17718,-30309,-12591,-1954,0,-10637,2616,256,-7765,45954
"520",1983,"Dallas",29322,12692,372160,1658,NA,0.0322,8.62,95247,13373,8529,4844,90996,5349,9245,2936,7441,38120,4159,3623,58243,-25347,-914,-24433,0,108620,90996,17624,-25347,-7723,-2535,0,-5188,2666,241,-2281,57127
"521",1983,"Davis",8992,8676,78015,917,NA,0.0322,8.62,32205,5589,3540,2049,36974,5067,2509,1089,3044,24128,2114,1308,21843,-4596,-1546,-3050,0,37794,36974,820,-4596,-3776,-290,0,-3486,842,82,-2562,8077
"522",1983,"Decatur",9280,7542,69993,684,NA,0.0322,8.62,31801,4789,2975,1814,39996,4104,5325,895,3061,24890,2287,1831,22493,-5018,-1527,-3491,0,36590,39996,-3406,-5018,-8424,-1510,0,-6914,1239,115,-5560,6911
"523",1983,"Delaware",18729,8674,162456,2077,NA,0.0322,8.62,167523,13384,8269,5115,164221,27358,12750,3458,9989,138713,8475,6016,96175,-33920,-1210,-32710,0,180907,164221,16686,-33920,-17234,-2618,NA,-14615,4060,423,-10132,28810
"524",1983,"Des Moines",44709,11837,529201,1634,NA,0.0322,8.62,54680,8279,5662,2617,50711,5173,3579,1914,5037,21803,2989,2330,29689,-13917,-670,-13247,0,62959,50711,12248,-13917,-1669,-472,0,-1197,2179,194,1176,32877
"525",1983,"Dickinson",15243,11688,178159,1795,NA,0.0322,8.62,76164,9505,7210,2295,73142,11291,13675,1854,4680,42133,3117,2594,35931,-15340,-1183,-14157,0,85669,73142,12527,-15340,-2813,-694,0,-2119,2016,191,88,34031
"526",1983,"Dubuque",90296,10976,991046,1867,NA,0.0322,8.62,152564,8329,3967,4362,148152,24241,16154,2650,6474,138437,6988,5967,85678,-30441,-2725,-27716,0,160893,148152,12741,-30441,-17700,-1075,NA,-16624,4055,445,-12124,14127
"527",1983,"Emmet",12823,10355,132784,2026,NA,0.0322,8.62,74655,11688,9276,2412,63978,4571,7417,2162,5378,27539,3524,1956,38970,-20962,-913,-20049,0,86343,63978,22365,-20962,1403,NA,0,1449,1327,125,2901,47116
"528",1983,"Fayette",24457,9238,225927,1845,NA,0.0322,8.62,159208,19470,14393,5077,155759,19759,15149,3974,10994,105548,8056,6728,91099,-39652,-2141,-37511,0,178678,155759,22919,-39652,-16733,-4186,NA,-12546,4594,455,-7497,53660
"529",1983,"Floyd",18998,10518,199814,1949,116,0.0322,8.62,99011,14977,10969,4008,88511,7017,7374,2865,7852,38130,5234,4264,53905,-23887,-614,-23273,0,113988,88511,25477,-23887,1590,-114,0,1704,3363,312,5379,60881
"530",1983,"Franklin",12721,10258,130496,2198,128,0.0322,8.62,140165,18844,14333,4511,128455,16479,14615,3773,9767,69941,5938,5336,72547,-34576,-702,-33874,0,159009,128455,30554,-34576,-4022,-1002,NA,-3019,3952,373,1306,70224
"531",1983,"Fremont",9059,12222,110721,1370,NA,0.0322,8.62,81429,13401,10134,3267,68800,7391,12272,2285,5228,30973,3432,3382,34810,-18925,-1005,-17920,0,94830,68800,26030,-18925,7105,-385,0,7490,2552,243,10285,50456
"532",1983,"Greene",11707,11749,137547,1987,114,0.0322,8.62,114383,16071,11237,4834,93864,9399,9894,3168,7942,39719,4456,4306,54699,-29095,-1109,-27986,0,130454,93864,36590,-29095,7495,-502,0,7997,3069,271,11337,74664
"533",1983,"Grundy",13781,12096,166689,2339,153,0.0322,8.62,142687,16091,10722,5369,114217,13993,15657,2996,8858,65704,5013,5474,62226,-35684,-739,-34945,0,158778,114217,44561,-35684,8877,-974,NA,9852,4209,383,14444,76983
"534",1983,"Guthrie",11551,9970,115158,1373,NA,0.0322,8.62,76575,11407,7664,3743,74645,9019,9292,1811,5929,42815,3802,2698,42094,-21062,-1970,-19092,0,87982,74645,13337,-21062,-7725,-921,0,-6804,1817,183,-4804,33760
"535",1983,"Hamilton",17429,12585,219342,2388,127,0.0322,8.62,161125,18360,14331,4029,140171,29847,16090,3309,9271,87299,6630,6127,68897,-30478,-271,-30207,0,179485,140171,39314,-30478,8836,-421,NA,9258,4308,418,13984,73826
"536",1983,"Hancock",13412,12251,164305,2209,129,0.0322,8.62,126012,16916,12842,4074,103579,12694,9788,3503,8688,59878,6353,3626,58927,-29547,-397,-29150,0,142928,103579,39349,-29547,9802,-361,0,10163,2494,235,12892,66134
"537",1983,"Hardin",21322,11588,247072,2199,NA,0.0322,8.62,155084,19522,14022,5500,135620,15850,18873,3623,9935,78304,5734,6380,75225,-41614,-1246,-40368,0,174606,135620,38986,-41614,-2628,-846,NA,-1781,4647,437,3303,76780
"538",1983,"Harrison",15804,10006,158131,1298,NA,0.0322,8.62,86804,15512,11961,3551,75336,5729,7301,2974,8409,33535,4665,3922,42336,-26029,-1187,-24842,0,102316,75336,26980,-26029,951,NA,0,980,2719,270,3969,53269
"539",1983,"Henry",18552,10702,198545,1518,NA,0.0322,8.62,61307,9128,6324,2804,73037,12328,5794,2005,5799,38003,3315,2308,41488,-10916,-508,-10408,0,70435,73037,-2602,-10916,-13518,-3699,0,-9819,1939,169,-7711,23304
"540",1983,"Howard",10778,9475,102118,1412,NA,0.0322,8.62,81326,12587,8949,3638,71944,8268,5803,2396,5906,44159,4819,3143,41609,-22363,-1336,-21027,0,93913,71944,21969,-22363,-394,-58,0,-336,2042,203,1909,37167
"541",1983,"Humboldt",11933,11029,131607,2399,129,0.0322,8.62,93431,11122,8844,2278,79026,7625,9795,2639,7036,39338,4067,2654,45210,-22734,-462,-22272,0,104553,79026,25527,-22734,2793,-71,0,2864,1880,183,4927,54093
"542",1983,"Ida",8797,9216,81074,1770,NA,0.0322,8.62,88497,11781,8885,2896,84840,10285,17821,2091,5459,55448,3877,2936,42371,-24674,-2107,-22567,0,100278,84840,15438,-24674,-9236,-1033,0,-8203,1801,168,-6234,33049
"543",1983,"Iowa",15102,10628,160499,1609,NA,0.0322,8.62,98856,14340,10740,3600,105067,15377,14390,2637,7926,69884,4945,4006,55786,-21681,-1876,-19805,0,113196,105067,8129,-21681,-13552,-4441,0,-9111,2506,247,-6358,28972
"544",1983,"Jackson",21989,9248,203356,1670,NA,0.0322,8.62,90713,8515,5052,3463,96058,10702,12932,2075,5817,76552,4576,3770,56186,-20557,-2692,-17865,0,99228,96058,3170,-20557,-17387,-2002,0,-15385,2763,298,-12324,14161
"545",1983,"Jasper",35243,12407,437255,1720,NA,0.0322,8.62,145913,17135,11953,5182,122072,16668,14952,3728,9680,86933,6106,5358,65580,-30610,-1432,-29178,0,163048,122072,40976,-30610,10366,-524,NA,10891,4106,373,15370,58980
"546",1983,"Jefferson",16140,9307,150223,1107,NA,0.0322,8.62,45091,7673,5271,2402,52817,5661,4906,1697,5101,29006,2926,1860,30666,-6090,-753,-5337,0,52764,52817,-53,-6090,-6143,-1275,0,-4868,1543,136,-3189,16085
"547",1983,"Johnson",86012,12251,1053703,2039,NA,0.0322,8.62,107496,11565,7200,4365,105236,18440,8911,2750,8243,71176,5066,4347,57479,-25643,-1204,-24439,0,119061,105236,13825,-25643,-11818,-2966,0,-8852,3290,289,-5273,36320
"548",1983,"Jones",19924,8882,176971,1732,NA,0.0322,8.62,113927,12107,7391,4716,119224,14942,14641,2868,9407,80528,5532,4486,67348,-28917,-1445,-27472,0,126034,119224,6810,-28917,-22107,-6832,0,-15275,3308,307,-11660,33399
"549",1983,"Keokuk",12575,10403,130820,1380,NA,0.0322,8.62,86740,12169,9212,2957,94785,14453,7183,2501,8002,62296,4927,2701,55018,-11295,-893,-10402,0,98909,94785,4124,-11295,-7171,-1113,0,-6058,2104,196,-3758,24444
"550",1983,"Kossuth",21016,11046,232151,2206,125,0.0322,8.62,229290,30115,24280,5835,191840,22473,19538,5854,14575,103189,10847,6404,112149,-53726,-1034,-52692,0,259405,191840,67565,-53726,13839,-470,NA,14311,4531,444,19286,126101
"551",1983,"Lee",41895,11254,471497,1396,NA,0.0322,8.62,57935,6034,3838,2196,62470,9339,6822,1751,5508,41147,3427,2495,33128,-8153,-928,-7225,0,63969,62470,1499,-8153,-6654,-1830,0,-4824,1987,187,-2650,16788
"552",1983,"Linn",165409,13062,2160547,2203,NA,0.0322,8.62,101889,13483,8813,4670,109329,8993,8592,3445,9715,53112,5621,4918,68045,-25084,-1127,-23957,0,115372,109329,6043,-25084,-19041,-5630,0,-13411,3541,315,-9555,48777
"553",1983,"Louisa",11984,9901,118653,1842,NA,0.0322,8.62,50624,11152,8872,2280,55455,5095,2849,2013,5646,23598,2939,2250,34663,-12721,-341,-12380,0,61776,55455,6321,-12721,-6400,-1633,0,-4767,1641,141,-2985,27026
"554",1983,"Lucas",10070,10403,104762,787,NA,0.0322,8.62,23661,4335,2852,1483,29846,3915,2505,745,2071,17258,1729,913,17968,-4316,-1152,-3164,0,27996,29846,-1850,-4316,-6166,-457,0,-5709,482,45,-5182,6403
"555",1983,"Lyon",12743,9910,126283,1869,NA,0.0322,8.62,154416,13591,8931,4660,128158,21397,28431,2858,6467,105127,5297,4551,59157,-30998,-2621,-28377,0,168007,128158,39849,-30998,8851,-331,NA,9183,2836,275,12294,49289
"556",1983,"Madison",12315,10608,130639,1193,82,0.0322,8.62,58633,8359,5773,2586,58643,7702,5853,1567,4134,37222,3122,2256,34009,-14563,-1915,-12648,0,66992,58643,8349,-14563,-6214,-699,0,-5515,1561,148,-3806,21411
"557",1983,"Mahaska",22012,10486,230809,1401,NA,0.0322,8.62,113806,11517,7733,3784,109047,19803,14913,2683,6685,84869,5380,4532,55051,-15369,-1287,-14082,0,125323,109047,16276,-15369,907,NA,0,930,3142,302,4374,28937
"558",1983,"Marion",29676,12329,365861,1363,NA,0.0322,8.62,73034,8334,5569,2765,66334,10602,5891,2041,4578,48972,3750,2946,36526,-10803,-1256,-9547,0,81368,66334,15034,-10803,4231,-93,0,4324,2050,199,6573,24062
"559",1983,"Marshall",41530,12541,520841,1865,NA,0.0322,8.62,111286,21598,16659,4939,97600,10912,8782,2948,8352,46465,5115,5262,56229,-32016,-1116,-30900,0,132884,97600,35284,-32016,3268,-283,0,3551,4135,370,8056,64821
"560",1983,"Mills",13360,11260,150435,1438,NA,0.0322,8.62,68096,10409,7373,3036,57298,5764,8986,1772,5557,30994,3013,2588,29618,-17675,-1116,-16559,0,78505,57298,21207,-17675,3532,-125,0,3657,1434,130,5221,37102
"561",1983,"Mitchell",11842,10671,126365,1889,107,0.0322,8.62,107793,12225,8650,3575,98945,14395,11540,2793,6638,65520,4831,3472,55276,-24348,-1007,-23341,0,120018,98945,21073,-24348,-3275,-422,0,-2853,2167,212,-474,42273
"562",1983,"Monona",11419,9665,110362,1233,NA,0.0322,8.62,84124,17383,13656,3727,76483,6586,11393,2748,8236,38422,4195,3089,40236,-27893,-1508,-26385,0,101507,76483,25024,-27893,-2869,-275,0,-2594,1772,175,-647,45702
"563",1983,"Monroe",8853,9642,85363,879,NA,0.0322,8.62,27679,4472,2834,1638,31587,4532,4730,655,1843,22411,1522,1023,17282,-4233,-1648,-2585,0,32151,31587,564,-4233,-3669,-96,0,-3573,630,62,-2881,5268
"564",1983,"Montgomery",13129,11245,147639,1318,NA,0.0322,8.62,64065,9924,7167,2757,55832,5401,8336,1815,4713,33655,3327,2501,29739,-16223,-1435,-14788,0,73989,55832,18157,-16223,1934,NA,0,1980,1630,158,3768,30410
"565",1983,"Muscatine",41068,12597,517323,2052,NA,0.0322,8.62,75896,7070,5083,1987,73479,7961,6525,2120,6693,39745,3978,3389,42813,-20869,-664,-20205,0,82966,73479,9487,-20869,-11382,-4496,0,-6886,2964,269,-3653,36151
"566",1983,"O'Brien",16917,11146,188556,2310,NA,0.0322,8.62,178815,17223,12360,4863,148687,25584,32545,3249,8197,112130,5477,4588,69047,-33797,-2123,-31674,0,196038,148687,47351,-33797,13554,-533,NA,14088,3351,313,17752,66685
"567",1983,"Osceola",8130,9697,78835,2011,NA,0.0322,8.62,89728,12541,10145,2396,86370,12003,14056,2446,5441,50076,4309,2170,45945,-17867,-1108,-16759,0,102269,86370,15899,-17867,-1968,-475,0,-1493,1709,154,370,39652
"568",1983,"Page",18356,10802,198285,1220,NA,0.0322,8.62,84685,10777,6966,3811,77312,7460,9780,2389,4807,41265,3586,5224,44066,-16976,-1554,-15422,0,95462,77312,18150,-16976,1174,NA,0,1207,3966,393,5566,43420
"569",1983,"Palo Alto",12454,9981,124301,1968,NA,0.0322,8.62,105652,17655,13609,4046,101018,10249,10495,3271,8030,47038,5200,4014,59759,-26514,-608,-25906,0,123307,101018,22289,-26514,-4225,-1050,0,-3175,2964,274,63,58614
"570",1983,"Plymouth",24290,9764,237161,1736,NA,0.0322,8.62,194205,16804,10454,6350,183172,29023,33557,4185,10584,138485,8325,6055,91443,-39358,-2526,-36832,0,211009,183172,27837,-39358,-11521,-1293,NA,-10227,3430,341,-6456,55720
"571",1983,"Pocahontas",10927,10313,112695,2272,109,0.0322,8.62,107179,17617,13123,4494,97512,10350,12085,3564,8222,46265,5294,3089,54908,-25108,-915,-24193,0,124796,97512,27284,-25108,2176,-94,0,2270,2293,209,4772,60914
"572",1983,"Polk",305725,14324,4379057,1967,NA,0.0322,8.62,64820,10896,8555,2341,59137,3923,3504,2310,5521,18789,2966,3198,37715,-18888,-391,-18497,0,75716,59137,16579,-18888,-2309,-944,0,-1365,2798,245,1678,46031
"573",1983,"Pottawattamie",85466,11463,979697,1433,NA,0.0322,8.62,184359,22591,17108,5483,168655,17606,35593,4462,13063,101930,8223,5849,83859,-40763,-3095,-37668,0,206950,168655,38295,-40763,-2468,-566,NA,-1901,4507,402,3008,82429
"574",1983,"Poweshiek",19045,11104,211483,1620,NA,0.0322,8.62,90787,12904,9521,3383,86114,10086,8268,2529,6956,50944,4736,3281,50258,-22459,-1863,-20596,0,103691,86114,17577,-22459,-4882,-646,0,-4236,2216,224,-1796,39843
"575",1983,"Ringgold",6000,8690,52141,806,NA,0.0322,8.62,38039,5322,3715,1607,40783,4576,4135,987,3258,26631,2429,1483,23915,-7781,-2202,-5579,0,43361,40783,2578,-7781,-5203,-523,0,-4680,1175,113,-3392,11408
"576",1983,"Sac",13456,10388,139776,2052,NA,0.0322,8.62,150221,14622,10552,4070,138425,22151,26723,3323,8579,96134,6156,5210,66283,-30172,-2013,-28159,0,164843,138425,26418,-30172,-3754,-755,NA,-2998,3849,359,1210,54087
"577",1983,"Scott",157397,12761,2008520,2856,NA,0.0322,8.62,106859,7110,4789,2321,99958,12997,10235,2905,8937,57280,4739,3597,56548,-32016,-666,-31350,0,113969,99958,14011,-32016,-18005,-6989,0,-11016,3139,294,-7583,49579
"578",1983,"Shelby",14629,9900,144824,1486,NA,0.0322,8.62,112812,16604,12883,3721,108957,14819,18975,2895,7488,69278,5600,3421,55759,-28496,-2247,-26249,0,129416,108957,20459,-28496,-8037,-1252,0,-6785,2550,238,-3997,43534
"579",1983,"Sioux",30698,10018,307526,1966,NA,0.0322,8.62,348498,23905,15189,8716,318056,64686,86566,4315,10682,290471,9185,9170,133452,-43343,-5279,-38064,0,372403,318056,54347,-43343,11004,-265,NA,11271,6278,613,18162,58027
"580",1983,"Story",73316,10877,797430,2239,NA,0.0322,8.62,124997,17479,12151,5328,103868,11307,9183,3285,8587,46969,4923,5833,60750,-32824,-439,-32385,0,142476,103868,38608,-32824,5784,-504,0,6288,4433,394,11115,78028
"581",1983,"Tama",19041,10571,201286,1806,131,0.0322,8.62,120685,21707,16051,5656,114851,12591,10444,3411,9461,58552,6232,4712,68000,-36455,-1778,-34677,0,142392,114851,27541,-36455,-8914,-1580,0,-7334,3361,320,-3653,62133
"582",1983,"Taylor",8208,8832,72494,910,NA,0.0322,8.62,41144,8645,6268,2377,43907,5266,3313,1247,3216,24863,2799,1828,26238,-9450,-1382,-8068,0,49789,43907,5882,-9450,-3568,-459,0,-3109,1183,110,-1816,16281
"583",1983,"Union",13660,10536,143925,978,NA,0.0322,8.62,38346,5453,3377,2076,40476,4552,4655,993,2831,25596,2052,1755,23638,-9617,-1885,-7732,0,43799,40476,3323,-9617,-6294,-755,0,-5539,1208,124,-4207,12750
"584",1983,"Van Buren",8424,8277,69727,993,NA,0.0322,8.62,34579,6317,4212,2105,41148,4596,2410,1132,3596,22967,2270,1744,25400,-4839,-943,-3896,0,40896,41148,-252,-4839,-5091,-689,0,-4402,1315,117,-2970,11612
"585",1983,"Wapello",39069,10578,413271,1021,NA,0.0322,8.62,35152,5787,4070,1717,40944,3570,3284,1380,4447,21807,2448,1623,24192,-4770,-896,-3874,0,40939,40944,NA,-4770,-4775,-818,0,-3957,1178,107,-2672,13345
"586",1983,"Warren",34710,11161,387387,1384,NA,0.0322,8.62,60952,9086,6201,2885,61130,7570,3880,1881,5238,38127,3642,3555,35364,-12016,-1398,-10618,0,70038,61130,8908,-12016,-3108,-699,0,-2409,2569,243,403,22825
"587",1983,"Washington",19862,12193,242168,1785,NA,0.0322,8.62,139551,11464,8380,3084,115418,24902,9539,2916,9101,105267,6095,4403,58462,-20148,-407,-19741,0,151015,115418,35597,-20148,15449,-1235,NA,16685,3950,349,20984,34284
"588",1983,"Wayne",7869,9458,74427,800,NA,0.0322,8.62,32613,6964,4655,2309,38655,3873,3526,1261,3697,24246,2371,1495,22432,-5427,-1849,-3578,0,39577,38655,922,-5427,-4505,-429,0,-4076,929,86,-3061,8367
"589",1983,"Webster",44110,11495,507034,2354,125,0.0322,8.62,144600,21399,16214,5185,114465,15050,7141,3637,10419,44311,5880,5889,66449,-39184,-275,-38909,0,165999,114465,51534,-39184,12350,-445,NA,12796,4165,407,17368,100289
"590",1983,"Winnebago",12551,11118,139544,2020,119,0.0322,8.62,74058,16784,13944,2840,69271,5317,4073,2277,6578,26160,4534,2066,44426,-22878,-145,-22733,0,90842,69271,21571,-22878,-1307,-371,0,-936,1471,136,671,47898
"591",1983,"Winneshiek",21760,8442,183695,1444,NA,0.0322,8.62,130640,11865,7293,4572,127724,18480,10621,2825,6573,108970,7277,5854,76094,-31987,-3420,-28567,0,142505,127724,14781,-31987,-17206,-1353,0,-15853,3735,400,-11718,21670
"592",1983,"Woodbury",99807,11749,1172657,1390,NA,0.0322,8.62,125124,20758,14939,5819,136438,16625,26384,3645,11329,83158,6184,5734,66537,-32782,-3510,-29272,0,145882,136438,9444,-32782,-23338,-2302,0,-21036,3209,318,-17509,41966
"593",1983,"Worth",8865,9988,88540,1998,111,0.0322,8.62,76741,13805,11100,2705,69012,6562,7347,2358,6538,33852,4033,2431,39743,-21675,-147,-21528,0,90546,69012,21534,-21675,-141,NA,0,-126,1553,156,1583,42889
"594",1983,"Wright",15767,12509,197237,2401,129,0.0322,8.62,117284,17234,12600,4634,96821,8920,8522,3459,8713,36879,5060,4624,57523,-31037,-244,-30793,0,134518,96821,37697,-31037,6660,-313,0,6973,3216,306,10495,80405
"595",1984,"Adair",9147,10680,97688,833,NA,0.043,9.54,65450,8629,5782,2847,75152,7456,7756,2749,8164,38907,3990,3089,41948,4300,-2927,7227,0,74079,75152,-1073,4300,3227,125,0,3102,1538,136,4776,26543
"596",1984,"Adams",5423,10060,54555,835,NA,0.043,9.54,38489,4752,3248,1504,46845,4528,4563,1667,4722,27619,2687,1962,26716,912,-1738,2650,0,43241,46845,-3604,912,-2692,-200,0,-2492,1186,116,-1190,10870
"597",1984,"Allamakee",14829,10824,160510,856,87,0.043,9.54,82174,10913,8611,2302,86436,9178,4965,2079,5333,70988,4805,3740,56336,4194,-3448,7642,0,93087,86436,6651,4194,10845,173,0,10672,2200,221,13093,11186
"598",1984,"Appanoose",14640,9861,144364,581,NA,0.043,9.54,21647,2947,1920,1027,29905,1796,1812,904,2913,13278,1674,1171,19635,844,-1447,2291,0,24594,29905,-5311,844,-4467,-259,0,-4208,658,59,-3491,8369
"599",1984,"Audubon",8312,10887,90495,1164,NA,0.043,9.54,83398,8479,5690,2789,91713,11666,12946,2517,8282,56012,4251,3586,48465,4371,-2694,7065,0,91877,91713,164,4371,4535,53,0,4482,2014,199,6695,27386
"600",1984,"Benton",22822,12366,282211,1649,NA,0.043,9.54,138120,15314,10798,4516,146402,13464,15418,4894,16625,75353,6962,5506,83533,10911,-2677,13588,0,153434,146402,7032,10911,17943,1039,NA,16905,3610,333,20848,62767
"601",1984,"Black Hawk",133873,12400,1660084,1867,143,0.043,9.54,104454,13411,9400,4011,113972,10990,7776,4243,12207,54729,5276,5767,67713,8424,-1733,10157,0,117865,113972,3893,8424,12317,1298,0,11019,3852,349,15220,49725
"602",1984,"Boone",25709,12695,326379,1762,120,0.043,9.54,94733,7737,5103,2634,97607,8076,8604,3941,11310,41718,4420,4482,56774,6108,-1553,7661,0,102470,97607,4863,6108,10971,1113,0,9858,3298,280,13436,53015
"603",1984,"Bremer",24199,12128,293495,1588,131,0.043,9.54,80071,11942,9117,2825,90460,9010,6135,3160,9167,48239,4432,3288,55268,7067,-1454,8521,0,92013,90460,1553,7067,8620,453,0,8167,1949,183,10299,31832
"604",1984,"Buchanan",22253,10974,244208,1629,138,0.043,9.54,111205,13121,10472,2649,121356,11911,9327,4175,14311,63917,5954,4397,71281,11394,-2311,13705,0,124326,121356,2970,11394,14364,675,0,13689,2802,260,16751,47288
"605",1984,"Buena Vista",20927,12016,251462,1590,119,0.043,9.54,129698,9977,6582,3395,135543,21061,16106,4169,12114,83520,5700,6785,69608,5437,-2403,7840,0,139675,135543,4132,5437,9569,512,NA,9058,4331,396,13785,46178
"606",1984,"Butler",17101,11907,203627,1696,139,0.043,9.54,112969,13732,10602,3130,117091,13441,10750,4075,12154,66867,5747,4794,66130,9715,-2049,11764,0,126701,117091,9610,9715,19325,1124,0,18201,2846,259,21306,46102
"607",1984,"Calhoun",12758,12104,154417,1752,116,0.043,9.54,103963,9511,6381,3130,104878,12327,13876,3676,10683,50661,4670,3657,55989,7442,-1765,9207,0,113474,104878,8596,7442,16038,373,0,15665,1951,178,17794,53302
"608",1984,"Carroll",22642,13017,294728,1415,109,0.043,9.54,171023,10416,6533,3883,164012,25365,41234,3684,10166,125243,6373,5619,71571,4886,-4372,9258,0,181439,164012,17427,4886,22313,986,NA,21328,3805,349,25482,45780
"609",1984,"Cass",16876,12331,208091,1066,NA,0.043,9.54,82126,8174,5870,2304,88969,8007,12802,3043,8861,51245,4465,3277,48514,5257,-2676,7933,0,90300,88969,1331,5257,6588,218,0,6370,1949,181,8500,30881
"610",1984,"Cedar",18430,13301,245137,2010,NA,0.043,9.54,122886,15239,11483,3756,131861,12377,12172,4653,14605,67401,6035,5057,76962,10733,-2336,13069,0,138125,131861,6264,10733,16997,1465,0,15532,3328,299,19159,55485
"611",1984,"Cerro Gordo",48059,13052,627279,1764,122,0.043,9.54,97860,17681,14910,2771,108478,9521,5059,3963,12812,45343,5836,4735,66552,8797,-1360,10157,0,115541,108478,7063,8797,15860,1132,0,14728,2769,250,17747,52517
"612",1984,"Cherokee",15657,11880,186008,1290,NA,0.043,9.54,129611,10898,7757,3141,130975,14142,23981,3384,8983,86945,4983,4399,71103,4530,-4183,8713,0,140509,130975,9534,4530,14064,443,NA,13622,2463,229,16314,42666
"613",1984,"Chickasaw",14898,11812,175970,1317,112,0.043,9.54,85897,12899,10466,2433,93558,9044,8251,3321,10603,53638,5101,3576,53662,6934,-1811,8745,0,98796,93558,5238,6934,12172,577,0,11595,2210,207,14012,32259
"614",1984,"Clarke",8493,9885,83953,659,63,0.043,9.54,24927,3677,2187,1490,32895,2578,1865,1129,3105,17845,1926,1158,21134,482,-1375,1857,0,28604,32895,-4291,482,-3809,-175,0,-3634,661,61,-2912,7082
"615",1984,"Clay",18953,11756,222808,1456,117,0.043,9.54,101857,11379,8230,3149,107858,11503,14277,3636,10521,59088,4831,4207,58883,4669,-1976,6645,0,113236,107858,5378,4669,10047,571,0,9476,2632,238,12346,42769
"616",1984,"Clayton",20506,11212,229921,1072,102,0.043,9.54,148114,20253,15764,4489,149788,19686,9261,4126,11748,120065,7726,5908,91333,11074,-4439,15513,0,168367,149788,18579,11074,29653,698,NA,28956,3416,337,32709,28049
"617",1984,"Clinton",54522,12421,677244,1673,NA,0.043,9.54,135982,16139,11636,4503,148922,12496,17959,4866,17097,75382,6798,5974,83732,13070,-3333,16403,0,152121,148922,3199,13070,16269,958,NA,15312,3897,362,19571,60600
"618",1984,"Crawford",18738,11173,209366,1176,NA,0.043,9.54,112105,13095,9008,4087,123414,13596,17020,3550,10543,69306,5737,4619,68349,7166,-3746,10912,0,125200,123414,1786,7166,8952,351,0,8601,2639,249,11489,42799
"619",1984,"Dallas",29180,13700,399753,1332,111,0.043,9.54,84518,8034,4379,3655,95270,4734,7791,3542,10060,34292,4061,3940,61142,7809,-1444,9253,0,92552,95270,-2718,7809,5091,429,0,4662,2567,230,7459,50226
"620",1984,"Davis",8931,9807,87584,746,NA,0.043,9.54,36823,5218,3672,1546,41394,4775,2539,1450,4420,23358,2218,1434,24558,2043,-1772,3815,0,42041,41394,647,2043,2690,55,0,2635,774,74,3483,13465
"621",1984,"Decatur",9097,8789,79958,540,62,0.043,9.54,33686,3853,2551,1302,41581,3722,4728,1103,4098,22708,2201,1862,23867,1471,-1696,3167,0,37539,41581,-4042,1471,-2571,-265,0,-2306,1155,105,-1046,10978
"622",1984,"Delaware",18751,11515,215911,1722,132,0.043,9.54,171398,17980,14051,3929,170262,25903,12360,4265,13641,138862,8410,6496,99187,11164,-4055,15219,0,189378,170262,19116,11164,30280,1164,NA,29117,4054,401,33572,32536
"623",1984,"Des Moines",44364,13103,581296,1349,NA,0.043,9.54,63197,6118,3933,2185,53719,4363,3121,2323,6871,20938,2859,2473,31709,7414,-1059,8473,0,69315,53719,15596,7414,23010,1646,0,21364,1924,170,23458,42259
"624",1984,"Dickinson",15218,13465,204913,1236,111,0.043,9.54,69494,7072,5119,1953,73013,9190,11909,2237,6306,38923,3044,2692,37635,3896,-1601,5497,0,76566,73013,3553,3896,7449,470,0,6979,1895,174,9048,30571
"625",1984,"Dubuque",89616,12367,1108242,1498,125,0.043,9.54,153608,17912,14611,3301,152984,22499,15650,3269,8998,137344,7002,6688,88878,8067,-4422,12489,0,171520,152984,18536,8067,26603,441,NA,26163,4193,430,30786,16264
"626",1984,"Emmet",12757,11371,145066,1500,122,0.043,9.54,61059,7216,5326,1890,66924,4036,6428,2618,7295,26460,3439,2112,40996,5064,-1323,6387,0,68275,66924,1351,5064,6415,245,0,6170,1263,116,7549,34599
"627",1984,"Fayette",24149,11241,271464,1483,124,0.043,9.54,149330,21453,17603,3850,159042,17352,13332,4844,14958,100046,7787,7168,93601,10532,-3564,14096,0,170783,159042,11741,10532,22273,1368,NA,20906,4412,422,25740,49284
"628",1984,"Floyd",18781,12206,229240,1618,113,0.043,9.54,90355,10058,7110,2948,91998,6541,6684,3542,10539,36540,5077,4424,55191,7550,-1265,8815,0,100413,91998,8415,7550,15965,1374,0,14591,3115,281,17987,53815
"629",1984,"Franklin",12515,12330,154315,1736,127,0.043,9.54,123612,18565,15302,3263,130857,14391,12413,4546,13318,66996,5812,5766,74611,8432,-2022,10454,0,142177,130857,11320,8432,19752,1177,0,18575,3653,334,22562,56616
"630",1984,"Fremont",9028,11877,107223,1118,NA,0.043,9.54,61445,7598,5228,2370,70099,5973,10099,2778,6946,28719,3307,3568,37428,4220,-1227,5447,0,69043,70099,-1056,4220,3164,203,0,2961,2492,228,5681,32726
"631",1984,"Greene",11490,12048,138426,1526,114,0.043,9.54,92498,9604,6011,3593,98665,7884,8321,3882,10962,35928,4456,4764,58396,5927,-1698,7625,0,102102,98665,3437,5927,9364,738,0,8626,2940,256,11822,56570
"632",1984,"Grundy",13514,13313,179912,1899,158,0.043,9.54,117426,11898,8018,3880,121061,12332,14866,3759,12446,63066,5077,5961,66620,7002,-1785,8787,0,129324,121061,8263,7002,15265,1976,0,13289,3914,347,17550,54360
"633",1984,"Guthrie",11595,11616,134693,1084,97,0.043,9.54,69027,7947,4831,3116,76536,7396,7826,2230,7984,37725,3775,2874,44451,5953,-2237,8190,0,76974,76536,438,5953,6391,200,0,6191,1673,162,8026,31302
"634",1984,"Hamilton",17203,13269,228259,1904,130,0.043,9.54,138330,10260,7170,3090,142768,26176,14450,4040,12425,83692,6458,6456,72763,6023,-1644,7667,0,148590,142768,5822,6023,11845,716,NA,11130,4262,394,15786,54638
"635",1984,"Hancock",13500,13786,186111,1740,130,0.043,9.54,111186,12819,9819,3000,110411,11064,9042,4319,12116,56710,6195,4103,63572,7901,-1724,9625,0,124005,110411,13594,7901,21495,935,0,20560,2510,230,23300,54476
"636",1984,"Hardin",21322,12796,272846,1772,131,0.043,9.54,128988,14431,10412,4019,137781,14160,16493,4455,13430,68007,5616,6558,77069,8967,-2440,11407,0,143419,137781,5638,8967,14605,1104,0,13501,4229,389,18119,60981
"637",1984,"Harrison",15628,11221,175369,1016,NA,0.043,9.54,76377,8153,5685,2468,81505,5069,6712,3629,11326,31342,4497,4039,46233,7653,-1630,9283,0,84530,81505,3025,7653,10678,404,0,10274,2549,241,13064,45035
"638",1984,"Henry",18553,12136,225168,1276,NA,0.043,9.54,65356,6761,4493,2268,74614,10419,5040,2420,7872,36012,3244,2596,43023,4843,-1387,6230,0,72117,74614,-2497,4843,2346,152,0,2194,1883,164,4241,29344
"639",1984,"Howard",10858,11826,128407,1150,97,0.043,9.54,74857,11946,9280,2666,76389,7524,5264,2922,8343,43265,4662,3473,44201,5736,-1916,7652,0,86803,76389,10414,5736,16150,551,0,15599,1984,189,17772,31592
"640",1984,"Humboldt",11829,12353,146129,1855,132,0.043,9.54,83074,8183,6435,1748,83719,6587,8876,3249,9491,38405,3934,2956,48626,5537,-1121,6658,0,91257,83719,7538,5537,13075,396,0,12679,1901,177,14757,44669
"641",1984,"Ida",8797,12443,109463,1307,NA,0.043,9.54,86162,8020,5908,2112,86457,8787,15735,2634,7633,52101,3745,3327,44596,6530,-2748,9278,0,94182,86457,7725,6530,14255,397,0,13858,1812,165,15835,34061
"642",1984,"Iowa",15118,13552,204881,1364,NA,0.043,9.54,105557,11141,8530,2611,106857,13042,12522,3283,10768,64904,4817,4371,58054,9096,-3054,12150,0,116698,106857,9841,9096,18937,1472,0,17465,2585,241,20291,40653
"643",1984,"Jackson",21858,11138,243462,1398,118,0.043,9.54,92211,11309,8774,2535,100210,10208,12480,2527,7886,73673,4569,4120,58420,6577,-3114,9691,0,103520,100210,3310,6577,9887,283,0,9604,2703,277,12584,18538
"644",1984,"Jasper",35024,13900,486829,1458,120,0.043,9.54,139322,11470,7616,3854,126718,14712,13129,4575,13229,82008,5977,5664,69432,10267,-3098,13365,0,150792,126718,24074,10267,34341,2151,NA,32191,3827,341,36359,57314
"645",1984,"Jefferson",16380,11315,185332,958,NA,0.043,9.54,54907,5784,3971,1813,54837,4784,4159,2080,7008,26985,2936,2038,31832,4728,-1395,6123,0,60691,54837,5854,4728,10582,560,0,10022,1423,125,11570,27922
"646",1984,"Johnson",87324,13320,1163121,1783,NA,0.043,9.54,110247,8701,5423,3278,109071,16501,8278,3380,11141,71668,5004,4703,60064,8207,-2804,11011,0,118948,109071,9877,8207,18084,1123,0,16961,3086,270,20317,38579
"647",1984,"Jones",19901,10997,218856,1513,NA,0.043,9.54,116963,14216,10863,3353,124256,13892,14694,3571,12554,78451,5464,4917,69164,10915,-2892,13807,0,131179,124256,6923,10915,17838,1387,0,16451,3135,290,19876,38512
"648",1984,"Keokuk",12504,12513,156464,1210,NA,0.043,9.54,96213,11189,8976,2213,100786,12629,6647,3274,11656,59340,5130,3163,58287,6338,-2747,9085,0,107402,100786,6616,6338,12954,521,0,12433,2110,192,14735,36873
"649",1984,"Kossuth",20827,12332,256847,1700,127,0.043,9.54,191933,26736,21986,4750,198359,19182,17050,7190,20111,96448,10627,6963,117236,12195,-2893,15088,0,218669,198359,20310,12195,32505,1252,NA,31254,4447,421,36122,95485
"650",1984,"Lee",41567,12478,518690,1116,NA,0.043,9.54,67666,5289,3552,1737,65144,8082,6172,2202,7591,40840,3346,2605,35146,5752,-1752,7504,0,72955,65144,7811,5752,13563,906,0,12657,1867,174,14698,26826
"651",1984,"Linn",165246,14081,2326864,1923,NA,0.043,9.54,102168,10840,7278,3562,116126,8287,8250,4310,13004,50250,5577,5520,71178,10095,-1777,11872,0,113008,116126,-3118,10095,6977,517,0,6460,3476,305,10241,51918
"652",1984,"Louisa",11998,11837,142020,1612,NA,0.043,9.54,58959,8579,6925,1654,58415,4352,2549,2445,7635,22786,2900,2473,36061,6544,-884,7428,0,67538,58415,9123,6544,15667,1048,0,14619,1582,138,16339,36173
"653",1984,"Lucas",10040,11264,113087,632,NA,0.043,9.54,23106,3811,2589,1222,31395,3412,2084,960,2902,15704,1709,1080,19248,1182,-1330,2512,0,26917,31395,-4478,1182,-3296,-163,0,-3133,514,47,-2572,7402
"654",1984,"Lyon",12583,11769,148093,1270,106,0.043,9.54,144213,12092,8366,3726,130392,18764,25895,3571,9019,101144,5258,4730,63155,4671,-3844,8515,0,156305,130392,25913,4671,30584,1416,NA,29169,2746,257,32172,43069
"655",1984,"Madison",12230,11916,145738,960,89,0.043,9.54,53466,5200,3264,1936,62698,7400,4946,1945,5680,34604,3049,2706,36972,2945,-2267,5212,0,58666,62698,-4032,2945,-1087,-77,0,-1010,1731,157,878,18862
"656",1984,"Mahaska",22136,11815,261534,1177,NA,0.043,9.54,114616,9129,6201,2928,112314,16976,13804,3350,9448,80838,5254,4913,58569,5867,-3084,8951,0,123745,112314,11431,5867,17298,558,0,16740,3153,289,20182,33778
"657",1984,"Marion",29635,13122,388885,1108,NA,0.043,9.54,66770,7299,5097,2202,69179,8920,5164,2584,6387,43006,3664,3339,39121,3230,-2075,5305,0,74069,69179,4890,3230,8120,255,0,7865,2130,197,10192,23764
"658",1984,"Marshall",40972,13411,549493,1557,120,0.043,9.54,94070,10937,7175,3762,101480,9313,8252,3710,11288,42834,5027,5552,58338,8448,-1858,10306,0,105007,101480,3527,8448,11975,1202,0,10773,3900,345,15018,51236
"659",1984,"Mills",13307,12739,169515,1148,NA,0.043,9.54,55849,6526,4112,2414,60188,4924,7754,2218,7406,28572,2919,2860,32107,3824,-1430,5254,0,62375,60188,2187,3824,6011,273,0,5738,1407,124,7269,27277
"660",1984,"Mitchell",11588,13257,153626,1555,NA,0.043,9.54,102298,10488,7676,2812,101523,13069,10723,3381,9127,66633,4779,3935,56509,5711,-2149,7860,0,112786,101523,11263,5711,16974,553,0,16421,2190,206,18817,35665
"661",1984,"Monona",11203,11036,123631,966,106,0.043,9.54,74121,9964,7077,2887,81550,5415,9949,3398,11085,33702,4102,3380,44221,7221,-1838,9059,0,84085,81550,2535,7221,9756,251,0,9505,1765,166,11436,40419
"662",1984,"Monroe",8696,10940,95130,727,NA,0.043,9.54,27194,3325,2116,1209,33573,3930,4138,894,2772,19527,1609,1182,19048,1044,-1762,2806,0,30519,33573,-3054,1044,-2010,NA,0,-1977,637,59,-1281,7667
"663",1984,"Montgomery",13166,12179,160349,1052,NA,0.043,9.54,53635,5938,3917,2021,59422,4823,7436,2288,6584,30655,3297,2749,32245,2467,-1807,4274,0,59573,59422,151,2467,2618,74,0,2544,1609,151,4304,22980
"664",1984,"Muscatine",40850,13994,571635,1793,NA,0.043,9.54,75750,7038,5391,1647,76023,6759,5607,2598,9004,35796,3862,3523,44670,8796,-1365,10161,0,82788,76023,6765,8796,15561,1461,0,14100,2690,241,17031,39954
"665",1984,"O'Brien",16696,12605,210461,1599,122,0.043,9.54,160977,12675,8916,3759,150896,22256,29263,4135,11607,105829,5534,4985,73116,5560,-3283,8843,0,173652,150896,22756,5560,28316,1338,NA,26979,3213,292,30484,55148
"666",1984,"Osceola",8059,11176,90068,1396,113,0.043,9.54,82219,9366,7572,1794,87505,10433,12364,2957,7472,46720,4208,2519,47552,3566,-1866,5432,0,91585,87505,4080,3566,7646,460,0,7186,1638,145,8969,35499
"667",1984,"Page",18178,11429,207760,941,NA,0.043,9.54,71459,6202,3335,2867,80648,6417,8519,3376,6765,38802,3514,5602,46455,1567,-2198,3765,0,77661,80648,-2987,1567,-1420,-106,0,-1314,3898,362,2946,32657
"668",1984,"Palo Alto",12163,11165,135803,1510,119,0.043,9.54,93369,12112,8894,3218,105323,8967,9535,3979,11064,45325,5090,4282,62406,6913,-1529,8442,0,105481,105323,158,6913,7071,427,0,6644,2722,245,9611,48044
"669",1984,"Plymouth",24076,11988,288618,1283,NA,0.043,9.54,192665,12725,7866,4859,185387,25437,31141,5145,14453,132040,8025,6540,94646,10237,-4902,15139,0,205390,185387,20003,10237,30240,862,NA,29379,3388,323,33090,60625
"670",1984,"Pocahontas",10837,11565,125326,1738,111,0.043,9.54,97160,10204,6968,3236,101761,9263,10392,4168,10839,45838,4997,3196,58906,5704,-1596,7300,0,107364,101761,5603,5704,11307,571,0,10736,2146,195,13077,51322
"671",1984,"Polk",307092,15423,4736365,1565,119,0.043,9.54,56105,5829,4004,1825,63293,3252,2989,2917,7748,16772,2970,3583,39834,5589,-664,6253,0,61934,63293,-1359,5589,4230,425,0,3805,2644,233,6682,39333
"672",1984,"Pottawattamie",85620,12530,1072837,1126,NA,0.043,9.54,170640,13860,9558,4302,171926,14491,29978,5574,17818,90582,8078,6480,89507,13205,-3925,17130,0,184500,171926,12574,13205,25779,1494,NA,24286,4404,388,29078,80058
"673",1984,"Poweshiek",18819,12866,242134,1385,116,0.043,9.54,84255,9385,6925,2460,90337,8684,7324,3152,9567,46871,4632,3524,53454,6104,-2824,8928,0,93640,90337,3303,6104,9407,299,0,9108,2157,208,11473,37384
"674",1984,"Ringgold",5966,9181,54774,640,54,0.043,9.54,34494,3886,2611,1275,42442,3978,3552,1220,4328,23829,2343,1635,25386,414,-2218,2632,0,38380,42442,-4062,414,-3648,-204,0,-3444,1111,106,-2227,10665
"675",1984,"Sac",13277,12147,161270,1476,NA,0.043,9.54,136895,10961,7790,3171,139428,18765,23820,4001,11477,91381,5934,5936,69495,5261,-3393,8654,0,147856,139428,8428,5261,13689,679,NA,13011,3925,355,17291,45514
"676",1984,"Scott",156282,13970,2183228,2528,NA,0.043,9.54,100250,8335,6294,2041,102137,10907,9402,3554,11703,54800,4695,3776,58100,9636,-1768,11404,0,108585,102137,6448,9636,16084,1576,0,14508,2859,265,17632,45450
"677",1984,"Shelby",14701,11929,175369,1133,NA,0.043,9.54,113815,9757,7012,2745,112912,12978,16815,3569,10517,65499,5491,3642,59900,9413,-3349,12762,0,123572,112912,10660,9413,20073,750,0,19323,2358,214,21895,48316
"678",1984,"Sioux",30605,12208,373619,1396,111,0.043,9.54,352156,20055,13224,6831,317865,58792,82889,5588,15394,291283,9129,10428,135645,6672,-7699,14371,0,372211,317865,54346,6672,61018,1863,NA,59157,6689,632,66478,60873
"679",1984,"Story",73408,11923,875217,1818,121,0.043,9.54,105239,12992,8997,3995,108981,10253,8855,3983,11604,45169,4872,6172,63242,8964,-1220,10184,0,118231,108981,9250,8964,18214,1883,0,16331,4198,367,20896,60070
"680",1984,"Tama",18997,12280,233284,1483,138,0.043,9.54,109097,13290,9307,3983,120727,11038,9371,4352,13261,53384,6108,5133,71464,10406,-2623,13029,0,122387,120727,1660,10406,12066,544,0,11522,3269,299,15090,55713
"681",1984,"Taylor",8090,9328,75463,732,69,0.043,9.54,36220,7078,5282,1796,46545,4596,2972,1560,4532,23280,2756,1948,28181,971,-1772,2743,0,43298,46545,-3247,971,-2276,-160,0,-2116,1101,102,-913,12940
"682",1984,"Union",13495,11214,151337,769,92,0.043,9.54,33677,4664,3144,1520,42809,4244,4679,1236,3857,22990,2044,1921,24828,1284,-1954,3238,0,38341,42809,-4468,1284,-3184,-219,0,-2965,1163,118,-1684,10687
"683",1984,"Van Buren",8296,9529,79053,821,NA,0.043,9.54,37746,4565,3068,1497,42996,4065,2232,1423,4996,20799,2188,1880,26212,2489,-1314,3803,0,42311,42996,-685,2489,1804,60,0,1744,1238,110,3092,16947
"684",1984,"Wapello",38815,11527,447421,865,NA,0.043,9.54,37220,4106,2747,1359,43857,3311,3113,1634,5779,20174,2399,1750,25871,2322,-1280,3602,0,41326,43857,-2531,2322,-209,NA,0,-190,1094,99,1003,17046
"685",1984,"Warren",34778,12085,420298,1072,88,0.043,9.54,56793,6516,4265,2251,64614,6569,3784,2307,6922,33389,3522,3679,37831,4212,-1868,6080,0,63309,64614,-1305,4212,2907,161,0,2746,2388,222,5356,23404
"686",1984,"Washington",19808,14074,278779,1574,NA,0.043,9.54,142577,11807,9362,2445,119269,21975,8779,3561,12087,100351,5956,4792,62119,8239,-2954,11193,0,154384,119269,35115,8239,43354,4185,NA,39170,3801,334,43305,42226
"687",1984,"Wayne",7817,10446,81657,624,NA,0.043,9.54,34214,5703,4020,1683,42988,3469,3419,1556,5071,21641,2427,1629,25417,1820,-1975,3795,0,39917,42988,-3071,1820,-1251,-59,0,-1192,814,75,-303,12573
"688",1984,"Webster",43469,11977,520636,1856,128,0.043,9.54,108585,12115,8290,3825,122390,13132,6076,4478,13986,42065,5777,6100,72841,6220,-1153,7373,0,120700,122390,-1690,6220,4530,197,0,4333,4101,382,8816,66520
"689",1984,"Winnebago",12633,13417,169498,1578,121,0.043,9.54,65919,12835,10771,2064,72538,4712,3756,2850,8799,25302,4319,2272,45830,6873,-699,7572,0,78754,72538,6216,6873,13089,925,0,12164,1399,128,13691,40617
"690",1984,"Winneshiek",21684,11047,239547,1161,87,0.043,9.54,130558,16707,13023,3684,131841,16295,10183,3446,9116,107141,7040,6152,79609,8378,-4349,12727,0,147265,131841,15424,8378,23802,425,NA,23378,3527,359,27264,23417
"691",1984,"Woodbury",99744,12572,1253934,1059,NA,0.043,9.54,123372,14956,10613,4343,140440,14504,23972,4471,15229,75069,5981,6052,70231,9302,-4296,13598,0,138328,140440,-2112,9302,7190,180,0,7010,3030,288,10328,48303
"692",1984,"Worth",8815,12393,109245,1604,112,0.043,9.54,67420,11478,9498,1980,71199,6043,6323,2831,8716,32215,3894,2475,40917,6569,-739,7308,0,78898,71199,7699,6569,14268,384,0,13884,1439,139,15462,35205
"693",1984,"Wright",15799,14069,222275,1878,132,0.043,9.54,96544,11512,8035,3477,101865,7354,7275,4291,11917,33966,4920,4699,61409,8323,-1003,9326,0,108056,101865,6191,8323,14514,814,0,13700,2936,268,16904,62578
"694",1985,"Adair",8935,11628,103896,606,NA,0.0355,7.47,62690,9134,5341,3793,69422,6667,6427,2545,7486,36328,3335,2888,40074,6879,-3790,10669,0,71824,69422,2402,6879,9281,489,0,8792,1479,135,10406,26362
"695",1985,"Adams",5307,11280,59865,612,NA,0.0355,7.47,37991,4426,2601,1825,42075,3717,3652,1516,4334,23058,2302,1910,24644,3831,-2127,5958,0,42417,42075,342,3831,4173,170,0,4003,1074,109,5186,14933
"696",1985,"Allamakee",14640,10938,160133,592,NA,0.0355,7.47,78645,6863,4112,2751,79070,8579,4544,1851,4895,70291,4030,3775,51396,610,-4684,5294,0,85508,79070,6438,610,7048,138,0,6910,2266,227,9403,8354
"697",1985,"Appanoose",14388,10182,146493,421,NA,0.0355,7.47,22387,2773,1552,1221,28845,1649,1801,836,2760,13108,1493,1167,19139,288,-2179,2467,0,25160,28845,-3685,288,-3397,-174,0,-3223,641,60,-2522,9279
"698",1985,"Audubon",8095,12111,98035,851,NA,0.0355,7.47,76838,9514,5930,3584,81811,10125,11048,2305,7539,51064,3636,3451,43707,9566,-3510,13076,0,86352,81811,4541,9566,14107,213,0,13894,1943,191,16028,25774
"699",1985,"Benton",22515,12534,282206,1121,NA,0.0355,7.47,118575,15795,10272,5523,135207,12123,15015,4405,14966,73718,5969,5668,77061,13555,-3507,17062,0,134370,135207,-837,13555,12718,910,0,11808,3481,326,15615,44857
"700",1985,"Black Hawk",130073,12620,1641477,1258,129,0.0355,7.47,94757,13762,8600,5162,103336,10405,6984,3739,11003,51387,4520,5803,60882,15405,-2029,17434,0,108519,103336,5183,15405,20588,2611,0,17977,3665,340,21982,43370
"701",1985,"Boone",25509,13415,342209,1174,109,0.0355,7.47,80303,10972,7926,3046,89415,6973,7601,3591,10384,37806,3855,4491,52520,11119,-1801,12920,0,91275,89415,1860,11119,12979,1673,0,11306,3185,277,14768,42497
"702",1985,"Bremer",23712,12511,296649,1082,123,0.0355,7.47,74160,9384,6064,3320,82481,8171,5449,2924,8581,46238,3819,3312,50225,11070,-1924,12994,0,83544,82481,1063,11070,12133,731,0,11402,1821,179,13402,27922
"703",1985,"Buchanan",21810,11183,243893,1112,126,0.0355,7.47,96690,13594,10362,3232,110888,10901,8573,3854,13103,61958,5169,4516,64772,15930,-2684,18614,0,110284,110888,-604,15930,15326,893,0,14433,2803,264,17500,34732
"704",1985,"Buena Vista",20572,13272,273039,1099,112,0.0355,7.47,126853,12439,8390,4049,124842,19997,14343,3720,10798,83080,4884,6707,64393,13916,-3098,17014,0,139292,124842,14450,13916,28366,1845,NA,26520,4317,395,31232,43773
"705",1985,"Butler",16782,12446,208866,1143,120,0.0355,7.47,103875,12698,8865,3833,107648,12573,9861,3665,11267,63860,4870,4892,60520,17405,-2273,19678,0,116573,107648,8925,17405,26330,1876,0,24454,2749,255,27458,40015
"706",1985,"Calhoun",12345,12929,159614,1179,103,0.0355,7.47,89207,12252,8514,3738,94561,10340,11349,3313,9717,44828,3939,3609,52294,15794,-1973,17767,0,101459,94561,6898,15794,22692,749,0,21943,2059,188,24190,44379
"707",1985,"Carroll",22433,13472,302213,994,101,0.0355,7.47,155255,12361,7453,4908,147998,22267,34358,3391,9498,115965,5502,5779,67203,10350,-5858,16208,0,167616,147998,19618,10350,29968,1587,NA,28380,3754,349,32483,39290
"708",1985,"Cass",16367,12945,211865,782,NA,0.0355,7.47,74311,9162,6236,2926,82051,7134,11342,2818,8071,45063,3828,3284,45574,9537,-3261,12798,0,83473,82051,1422,9537,10959,436,0,10523,1895,176,12594,29248
"709",1985,"Cedar",18216,13298,242240,1443,NA,0.0355,7.47,102630,14109,9347,4762,118560,11247,11089,4117,12962,61443,5043,4771,69331,15406,-2571,17977,0,116739,118560,-1821,15406,13585,1385,0,12200,2974,275,15449,41187
"710",1985,"Cerro Gordo",48497,13316,645790,1192,110,0.0355,7.47,83891,13966,10680,3286,96260,8386,4084,3522,11291,40856,5023,4696,59258,16445,-1532,17977,0,97857,96260,1597,16445,18042,1604,0,16438,2632,242,19312,43035
"711",1985,"Cherokee",15266,12550,191586,922,NA,0.0355,7.47,114632,11352,7451,3901,117035,12429,20340,3135,8426,79188,4318,4574,63813,9529,-5113,14642,0,125984,117035,8949,9529,18478,749,0,17729,2480,230,20439,35444
"712",1985,"Chickasaw",14485,12120,175560,898,99,0.0355,7.47,77334,11265,7830,3435,86323,8218,7901,3110,9833,51988,4376,3573,49312,10844,-2361,13205,0,88599,86323,2276,10844,13120,749,0,12371,2200,209,14780,25346
"713",1985,"Clarke",8387,10917,91557,478,72,0.0355,7.47,27575,3908,2168,1740,30869,2437,1660,1088,3019,17272,1728,1115,19822,1384,-2032,3416,0,31483,30869,614,1384,1998,50,0,1948,592,56,2596,10303
"714",1985,"Clay",18386,12815,235610,1007,107,0.0355,7.47,90773,12317,8543,3774,96354,10183,12346,3254,9386,54441,4092,3970,53123,11566,-2222,13788,0,103090,96354,6736,11566,18302,1302,0,17000,2445,226,19671,36332
"715",1985,"Clayton",20177,11261,227210,741,NA,0.0355,7.47,142053,13425,7264,6161,138815,18171,8526,3719,10730,120943,6580,6001,85088,9307,-5809,15116,0,155478,138815,16663,9307,25970,796,NA,25173,3430,341,28944,21110
"716",1985,"Clinton",53590,12710,681133,1193,NA,0.0355,7.47,112351,15750,10299,5451,131767,10832,15200,4360,15205,68554,5708,5784,74678,16695,-4495,21190,0,128101,131767,-3666,16695,13029,976,0,12053,3551,338,15942,43797
"717",1985,"Crawford",18330,11499,210782,852,NA,0.0355,7.47,96803,13392,8619,4773,113133,12187,15105,3312,9736,61912,4943,4778,63072,11260,-4663,15923,0,110195,113133,-2938,11260,8322,408,0,7914,2708,256,10878,34891
"718",1985,"Dallas",29247,13995,409319,909,101,0.0355,7.47,66415,11725,7068,4657,86564,4267,6317,3133,9086,29250,3469,3961,56331,11138,-1687,12825,0,78140,86564,-8424,11138,2714,290,0,2424,2494,227,5145,37165
"719",1985,"Davis",8788,10047,88289,536,NA,0.0355,7.47,35131,4523,2647,1876,38482,4354,2377,1347,4078,22463,1942,1359,23025,2217,-2433,4650,0,39654,38482,1172,2217,3389,91,0,3298,708,69,4075,12668
"720",1985,"Decatur",8911,9867,87929,391,53,0.0355,7.47,34513,3566,2080,1486,38837,3511,4175,1020,3749,21967,1898,1767,22717,2791,-2571,5362,0,38079,38837,-758,2791,2033,120,0,1913,1081,99,3093,12546
"721",1985,"Delaware",18514,11728,217136,1195,NA,0.0355,7.47,161844,13724,8654,5070,156426,24916,11647,3862,12455,138782,7327,6547,89672,12311,-4507,16818,0,175568,156426,19142,12311,31453,1517,NA,29935,4081,405,34421,23062
"722",1985,"Des Moines",43850,13567,594909,964,NA,0.0355,7.47,52125,7754,4662,3092,49240,3730,2636,2068,6266,19777,2381,2424,29735,10563,-1428,11991,0,59879,49240,10639,10563,21202,1898,0,19304,1644,154,21102,32348
"723",1985,"Dickinson",15048,13416,201881,869,102,0.0355,7.47,59276,7883,5054,2829,65053,7525,10046,1980,5674,35142,2601,2632,34595,7504,-1966,9470,0,67159,65053,2106,7504,9610,766,0,8844,1798,167,10809,24134
"724",1985,"Dubuque",89096,12876,1147224,1040,NA,0.0355,7.47,150854,9295,5207,4088,141366,21258,14739,2960,8371,139400,6170,7011,80857,4330,-5797,10127,0,160149,141366,18783,4330,23113,514,NA,22598,4393,448,27439,11454
"725",1985,"Emmet",12408,12245,151936,1037,109,0.0355,7.47,55208,9700,7200,2500,60845,3627,5391,2327,6611,23530,2937,2100,37852,12296,-1573,13869,0,64908,60845,4063,12296,16359,750,0,15609,1209,113,16931,31678
"726",1985,"Fayette",23378,11378,265984,1018,NA,0.0355,7.47,133269,16199,11338,4861,142709,15508,11380,4332,13602,95224,6568,7041,84278,12693,-4775,17468,0,149468,142709,6759,12693,19452,1455,NA,17996,4264,412,22672,38045
"727",1985,"Floyd",18523,12245,226811,1096,104,0.0355,7.47,77221,11556,7941,3615,82850,6205,5894,3215,9441,34888,4303,4292,49500,13341,-1599,14940,0,88777,82850,5927,13341,19268,2046,0,17222,2898,267,20387,42333
"728",1985,"Franklin",12398,12830,159070,1167,122,0.0355,7.47,108427,14994,11066,3928,117089,12785,10165,4017,12142,60210,4981,5753,67246,17351,-2192,19543,0,123421,117089,6332,17351,23683,1675,0,22008,3408,316,25732,48217
"729",1985,"Fremont",8829,13491,119112,816,NA,0.0355,7.47,63968,7933,5059,2874,64705,5005,8221,2539,6323,28419,2871,3632,36114,9455,-1791,11246,0,71901,64705,7196,9455,16651,1309,0,15342,2465,224,18031,35549
"730",1985,"Greene",11202,12765,142994,1037,104,0.0355,7.47,75580,12900,8379,4521,86600,6417,6453,3338,9675,31086,3748,4617,52352,11590,-1967,13557,0,88480,86600,1880,11590,13470,1288,0,12182,2839,252,15273,44494
"731",1985,"Grundy",13251,13547,179514,1272,143,0.0355,7.47,104305,12982,8273,4709,113128,11064,13734,3463,11710,58902,4531,5997,62629,13343,-2092,15435,0,117287,113128,4159,13343,17502,2754,0,14748,3665,332,18745,45403
"732",1985,"Guthrie",11417,12471,142378,775,88,0.0355,7.47,61467,10042,5633,4409,68955,6113,6341,2018,7178,34591,3293,2804,41208,9626,-3091,12717,0,71509,68955,2554,9626,12180,497,0,11683,1528,152,13363,26876
"733",1985,"Hamilton",16982,14213,241362,1272,116,0.0355,7.47,123916,13629,9638,3991,130127,23361,12614,3621,11112,75801,5501,6458,67460,14201,-2047,16248,0,137545,130127,7418,14201,21619,1699,NA,19919,4283,393,24595,48115
"734",1985,"Hancock",13380,14223,190298,1173,111,0.0355,7.47,102347,13772,10099,3673,102925,9808,8130,3910,11312,54695,5284,4260,60221,17288,-2031,19319,0,116119,102925,13194,17288,30482,1616,0,28866,2565,234,31665,47652
"735",1985,"Hardin",20878,13516,282192,1184,124,0.0355,7.47,114368,15323,10378,4945,123193,12885,13967,4022,12126,64377,4815,6205,69173,17757,-3107,20864,0,129691,123193,6498,17757,24255,2134,0,22121,3878,363,26362,49991
"736",1985,"Harrison",15450,12319,190328,748,NA,0.0355,7.47,75714,9558,6811,2747,75814,4560,5994,3246,10188,30071,3796,3867,44163,15313,-2237,17550,0,85272,75814,9458,15313,24771,1207,0,23564,2406,226,26196,45643
"737",1985,"Henry",18840,12697,239203,911,NA,0.0355,7.47,57089,8266,5186,3080,67052,8923,4245,2142,7140,32691,2778,2698,39126,8470,-1745,10215,0,65355,67052,-1697,8470,6773,515,0,6258,1820,163,8241,24398
"738",1985,"Howard",10567,11485,121364,784,NA,0.0355,7.47,63604,9816,6574,3242,70790,6976,4645,2615,7893,41439,3935,3499,41227,7300,-2400,9700,0,73420,70790,2630,7300,9930,395,0,9535,1945,188,11668,22165
"739",1985,"Humboldt",11620,12506,145324,1243,118,0.0355,7.47,70488,8948,6729,2219,77409,5781,7823,2936,8550,35080,3322,3072,45925,10986,-1229,12215,0,79436,77409,2027,10986,13013,487,0,12526,1931,179,14636,35408
"740",1985,"Ida",8751,12966,113464,949,NA,0.0355,7.47,76200,9128,6585,2543,78452,7619,13480,2436,7145,49063,3156,3419,41197,9737,-3888,13625,0,85328,78452,6876,9737,16613,572,0,16041,1855,170,18066,27137
"741",1985,"Iowa",15078,13564,204521,947,NA,0.0355,7.47,91095,10806,7701,3105,96041,11219,10553,3001,9777,59239,4103,4391,52997,11202,-3928,15130,0,101901,96041,5860,11202,17062,1560,0,15502,2681,251,18434,31856
"742",1985,"Jackson",21569,11201,241601,983,NA,0.0355,7.47,87668,8618,5630,2988,92427,9892,11710,2257,7144,74501,4009,4136,53279,2773,-4548,7321,0,96286,92427,3859,2773,6632,235,0,6397,2633,275,9305,13167
"743",1985,"Jasper",34715,14309,496728,1021,112,0.0355,7.47,117706,13746,8987,4759,115813,13218,11178,4122,12088,75400,5120,5550,64537,13358,-3887,17245,0,131452,115813,15639,13358,28997,2314,0,26683,3585,325,30593,42306
"744",1985,"Jefferson",16331,11813,192915,684,NA,0.0355,7.47,46828,6511,4257,2254,49440,4097,3398,1872,6442,24738,2593,2057,28981,6936,-1666,8602,0,53339,49440,3899,6936,10835,725,0,10110,1319,119,11548,22090
"745",1985,"Johnson",88538,13777,1219807,1275,NA,0.0355,7.47,94653,10164,6096,4068,99748,15039,7484,3051,10058,66810,4337,4706,55073,9853,-3162,13015,0,104817,99748,5069,9853,14922,1138,0,13784,2912,261,16957,27843
"746",1985,"Jones",19654,11157,219285,1076,NA,0.0355,7.47,102390,12090,8174,3916,113758,13147,14283,3264,11172,75638,4734,4915,62243,12750,-3708,16458,0,114480,113758,722,12750,13472,1308,0,12164,2984,285,15433,26752
"747",1985,"Keokuk",12393,12806,158708,861,NA,0.0355,7.47,84899,10695,7990,2705,90106,10728,5738,3024,10914,54722,4508,3295,51899,9899,-3231,13130,0,95594,90106,5488,9899,15387,793,0,14594,2137,196,16927,30177
"748",1985,"Kossuth",20402,12881,262793,1146,114,0.0355,7.47,170193,23470,16943,6527,179781,16618,14415,6482,18564,89205,9127,7035,107540,25046,-3583,28629,0,193663,179781,13882,25046,38928,1752,NA,37175,4408,417,42000,80988
"749",1985,"Lee",40797,13009,530739,802,NA,0.0355,7.47,62606,5764,3527,2237,59687,7110,5432,2034,7000,39351,2858,2516,32737,9534,-2220,11754,0,68370,59687,8683,9534,18217,1466,0,16751,1738,170,18659,23255
"750",1985,"Linn",164826,14944,2463117,1367,NA,0.0355,7.47,84374,11808,7340,4468,106917,7776,7704,3960,11614,48500,4857,5673,65333,11059,-2281,13340,0,96182,106917,-10735,11059,324,NA,0,295,3429,307,4031,35874
"751",1985,"Louisa",11792,12080,142453,1153,NA,0.0355,7.47,47531,8331,6359,1972,52960,3773,2217,2178,6896,20987,2511,2479,32906,9282,-1076,10358,0,55862,52960,2902,9282,12184,1054,0,11130,1535,137,12802,26544
"752",1985,"Lucas",9769,11860,115861,457,NA,0.0355,7.47,22152,3434,1791,1643,29024,3024,1663,910,2723,13938,1483,1115,18106,1107,-1801,2908,0,25586,29024,-3438,1107,-2331,-123,0,-2208,528,50,-1630,8214
"753",1985,"Lyon",12375,12249,151579,892,98,0.0355,7.47,130850,12154,7111,5043,119656,16745,22946,3276,8421,97222,4582,4484,59202,9600,-4852,14452,0,143004,119656,23348,9600,32948,1945,NA,31002,2680,254,33936,33628
"754",1985,"Madison",12205,12747,155579,689,66,0.0355,7.47,51948,5941,3601,2340,59168,7219,4024,1773,5219,32752,2606,3040,35287,6235,-3038,9273,0,57889,59168,-1279,6235,4956,218,0,4738,1931,174,6843,19196
"755",1985,"Mahaska",21844,12565,274466,841,NA,0.0355,7.47,107963,10173,6391,3782,103422,14779,12437,3073,8944,77583,4487,4991,54711,8702,-3852,12554,0,118136,103422,14714,8702,23416,975,0,22441,3208,293,25942,30380
"756",1985,"Marion",29517,13645,402772,797,NA,0.0355,7.47,62899,6770,3886,2884,63808,7602,4388,2403,5965,38943,3132,3527,36791,5939,-2724,8663,0,69669,63808,5861,5939,11800,527,0,11273,2243,207,13723,23956
"757",1985,"Marshall",40276,13953,561966,1059,111,0.0355,7.47,80326,13752,8892,4860,92090,8068,7546,3429,10192,39161,4330,5444,53081,13172,-2175,15347,0,94078,92090,1988,13172,15160,1820,0,13340,3710,335,17385,41165
"758",1985,"Mills",13335,14100,188026,838,NA,0.0355,7.47,52394,7935,4646,3289,55203,4271,6470,2039,6581,24609,2470,2814,30558,8252,-1868,10120,0,60329,55203,5126,8252,13378,800,0,12578,1396,127,14101,27785
"759",1985,"Mitchell",11426,13635,155799,1054,97,0.0355,7.47,88517,10654,6910,3744,91993,12086,9698,3003,8394,61311,4147,4064,50601,9613,-2487,12100,0,99171,91993,7178,9613,16791,686,0,16105,2256,212,18573,27206
"760",1985,"Monona",10836,11986,129878,715,NA,0.0355,7.47,67594,10697,6897,3800,75324,4500,8425,3078,9961,30793,3521,3360,42479,12878,-2652,15530,0,78291,75324,2967,12878,15845,535,0,15310,1780,170,17260,36801
"761",1985,"Monroe",8585,11506,98778,522,NA,0.0355,7.47,24901,2629,1203,1426,31793,3464,3508,891,2784,18066,1504,1219,18423,364,-2591,2955,0,27530,31793,-4263,364,-3899,-66,0,-3833,652,63,-3118,6835
"762",1985,"Montgomery",12838,12781,164087,768,NA,0.0355,7.47,49969,7007,4544,2463,55443,4386,6445,2118,6157,26391,2868,2770,30699,5270,-2295,7565,0,56976,55443,1533,5270,6803,234,0,6569,1606,152,8327,23578
"763",1985,"Muscatine",40414,14494,585742,1287,NA,0.0355,7.47,62488,7211,4978,2233,68487,5821,4655,2337,8088,33712,3275,3424,40887,10978,-1759,12737,0,69699,68487,1212,10978,12190,1347,0,10843,2430,221,13494,28776
"764",1985,"O'Brien",16318,13389,218487,1124,114,0.0355,7.47,147154,13930,9020,4910,138081,19689,25577,3866,11006,102991,4924,5044,67975,12640,-4408,17048,0,161084,138081,23003,12640,35643,2086,NA,33556,3110,286,36952,44163
"765",1985,"Osceola",7757,11584,89855,981,109,0.0355,7.47,68085,8981,6764,2217,77039,9029,10322,2569,6724,41708,3512,2628,42255,9003,-2005,11008,0,77066,77039,NA,9003,9030,672,0,8358,1566,144,10068,26377
"766",1985,"Page",17788,12589,223936,687,NA,0.0355,7.47,73881,7807,4192,3615,74344,5606,7186,3459,6374,36704,3015,5714,42990,6040,-2887,8927,0,81688,74344,7344,6040,13384,561,0,12823,3919,360,17102,37177
"767",1985,"Palo Alto",11894,12825,152544,1029,110,0.0355,7.47,89984,14107,9741,4366,95932,7983,8426,3552,10200,44913,4363,4230,57178,17859,-1826,19685,0,104091,95932,8159,17859,26018,1894,0,24124,2520,231,26875,45071
"768",1985,"Plymouth",23682,12896,305407,932,NA,0.0355,7.47,176187,15647,9405,6242,167701,22684,28130,4645,13196,127876,6748,6399,85899,17707,-5835,23542,0,191834,167701,24133,17707,41840,1503,NA,40336,3354,325,44015,48311
"769",1985,"Pocahontas",10737,13852,148731,1173,102,0.0355,7.47,97443,14463,10586,3877,94383,8584,8820,3633,9707,45544,4192,3079,56368,17682,-1983,19665,0,111906,94383,17523,17682,35205,2147,0,33058,2031,189,35278,51899
"770",1985,"Polk",308349,16106,4966255,1063,112,0.0355,7.47,45660,8061,5747,2314,58485,2724,2459,2705,7279,15457,2615,3770,36933,7894,-816,8710,0,53721,58485,-4764,7894,3130,385,0,2745,2501,225,5471,30203
"771",1985,"Pottawattamie",84830,13134,1114194,825,NA,0.0355,7.47,149271,17463,11809,5654,155207,12029,24295,5114,16246,79467,6952,6681,83890,22373,-5405,27778,0,166734,155207,11527,22373,33900,2465,NA,31434,4364,392,36190,69804
"772",1985,"Poweshiek",18892,12961,244853,963,104,0.0355,7.47,72187,10224,7300,2924,82987,7596,6299,2884,8803,43405,3965,3523,49917,6241,-3832,10073,0,82411,82987,-576,6241,5665,214,0,5451,2122,206,7779,28782
"773",1985,"Ringgold",5788,10227,59193,465,55,0.0355,7.47,35976,3991,2342,1649,41132,3739,3146,1177,4079,22388,2104,1760,25127,2042,-3238,5280,0,39967,41132,-1165,2042,877,NA,0,850,1071,104,2025,13588
"774",1985,"Sac",13077,12494,163389,1037,NA,0.0355,7.47,121458,11674,7497,4177,125744,16116,20622,3533,10244,82576,4991,6297,63941,11357,-4044,15401,0,133132,125744,7388,11357,18745,1138,NA,17606,4069,368,22043,38882
"775",1985,"Scott",154571,14480,2238247,1820,NA,0.0355,7.47,83122,8481,5517,2964,91148,9267,8403,3191,10190,51019,4082,3703,52312,12583,-2187,14770,0,91603,91148,455,12583,13038,1598,0,11440,2581,249,14270,32103
"776",1985,"Shelby",14205,12931,183682,835,NA,0.0355,7.47,101660,11882,8563,3319,103960,11566,14465,3229,9892,59053,4715,3588,56505,17274,-4167,21441,0,113542,103960,9582,17274,26856,1192,0,25664,2207,204,28075,42607
"777",1985,"Sioux",30439,12668,385612,996,102,0.0355,7.47,327532,21061,11997,9064,292403,54605,77546,5329,14904,276577,7972,11232,120815,15348,-9360,24708,0,348593,292403,56190,15348,71538,2839,NA,68697,7217,678,76592,50955
"778",1985,"Story",74050,12528,927693,1216,116,0.0355,7.47,89835,14435,9369,5066,99801,9470,8302,3544,10473,44077,4231,6029,57752,15920,-1413,17333,0,104270,99801,4469,15920,20389,2575,0,17814,3984,354,22152,45758
"779",1985,"Tama",18660,12799,238821,1004,136,0.0355,7.47,94869,14648,10055,4593,110863,9848,8173,4076,12445,49995,5241,5163,65917,15717,-3527,19244,0,109517,110863,-1346,15717,14371,815,0,13556,3227,298,17081,44874
"780",1985,"Taylor",7840,10982,86100,533,46,0.0355,7.47,41299,5519,3283,2236,43220,4081,2590,1435,4277,21622,2380,1878,26579,5669,-2384,8053,0,46818,43220,3598,5669,9267,354,0,8913,1028,99,10040,19677
"781",1985,"Union",13141,12071,158627,558,57,0.0355,7.47,34493,4330,2517,1813,39802,4028,4553,1130,3514,21488,1790,1901,22886,3580,-2758,6338,0,38823,39802,-979,3580,2601,103,0,2498,1124,117,3739,13005
"782",1985,"Van Buren",8120,10201,82834,589,NA,0.0355,7.47,34384,4329,2639,1690,39040,3660,2013,1315,4646,19489,1840,1851,23715,4224,-1789,6013,0,38713,39040,-327,4224,3897,157,0,3740,1180,107,5027,14895
"783",1985,"Wapello",38157,11881,453335,618,NA,0.0355,7.47,32964,4527,2803,1724,40481,3127,2871,1417,4986,18330,2059,1728,24293,2464,-1671,4135,0,37491,40481,-2990,2464,-526,NA,0,-481,1020,95,634,14634
"784",1985,"Warren",34776,12709,441951,761,76,0.0355,7.47,53645,6593,3746,2847,59612,5796,3585,2077,6092,31249,2973,3553,35536,8096,-2641,10737,0,60238,59612,626,8096,8722,591,0,8131,2225,211,10567,22396
"785",1985,"Washington",19766,14048,277680,1120,NA,0.0355,7.47,122177,10800,7590,3210,109445,19740,7864,3192,10700,88512,5092,4907,57950,13398,-3352,16750,0,132977,109445,23532,13398,36930,4437,NA,32492,3665,329,36486,33665
"786",1985,"Wayne",7521,11509,86559,452,NA,0.0355,7.47,35723,4936,2936,2000,39355,2993,3066,1333,4387,20181,2061,1518,23997,3875,-2965,6840,0,40659,39355,1304,3875,5179,121,0,5058,705,67,5830,15542
"787",1985,"Webster",42695,12485,533036,1240,114,0.0355,7.47,94961,15584,10864,4720,114252,11657,4986,4049,12532,38861,4975,5967,70086,15314,-1395,16709,0,110545,114252,-3707,15314,11607,626,0,10981,4115,382,15478,56100
"788",1985,"Winnebago",12536,13660,171247,1063,105,0.0355,7.47,54579,11550,9074,2476,65387,4253,3372,2622,7853,23721,3576,2266,41445,11803,-744,12547,0,66129,65387,742,11803,12545,1097,0,11448,1309,127,12884,30858
"789",1985,"Winneshiek",21431,11219,240427,797,NA,0.0355,7.47,123631,11955,7003,4952,120658,14627,9498,3087,8462,106613,5945,5959,73080,3234,-6297,9531,0,135586,120658,14928,3234,18162,363,NA,17798,3371,343,21512,17018
"790",1985,"Woodbury",98909,13256,1311110,781,NA,0.0355,7.47,110924,15547,10110,5437,127695,12870,21186,4026,13666,69939,5049,5825,65073,13296,-6186,19482,0,126471,127695,-1224,13296,12072,379,0,11693,2914,277,14884,40985
"791",1985,"Worth",8700,12585,109492,1084,101,0.0355,7.47,55442,10379,7974,2405,63682,5667,5262,2493,7749,27839,3280,2309,36922,12103,-769,12872,0,65821,63682,2139,12103,14242,470,0,13772,1347,131,15250,27603
"792",1985,"Wright",15395,13773,212032,1259,118,0.0355,7.47,78851,14590,10159,4431,93092,6116,5994,3910,10899,30591,4182,4427,57564,15740,-1132,16872,0,93441,93092,349,15740,16089,1109,0,14980,2701,249,17930,48260
"793",1986,"Adair",8700,13161,114501,507,67,0.0191,5.97,66988,12353,9049,3304,65497,6897,6757,2560,6513,41095,2583,2454,37733,4567,-2321,6888,0,79341,65497,13844,4567,18411,974,0,17437,1309,131,18877,25893
"794",1986,"Adams",5199,12746,66267,519,52,0.0191,5.97,38097,6714,5268,1446,38904,3532,3722,1520,3821,23912,1858,1712,22739,4369,-1286,5655,0,44811,38904,5907,4369,10276,381,0,9895,884,103,10882,14185
"795",1986,"Allamakee",14384,11820,170021,483,NA,0.0191,5.97,81189,9242,7107,2135,74472,9417,5393,1814,4319,72783,3167,3489,46873,-2265,-2899,634,0,90431,74472,15959,-2265,13694,248,0,13446,2161,238,15845,8406
"796",1986,"Appanoose",14150,10986,155456,351,NA,0.0191,5.97,23243,3770,2770,1000,28425,1779,2304,852,2516,14627,1265,1060,18649,3524,-1128,4652,0,27013,28425,-1412,3524,2112,59,0,2053,580,62,2695,8616
"797",1986,"Audubon",7848,12576,98698,751,NA,0.0191,5.97,73442,12720,9741,2979,76707,10286,12177,2327,6592,50419,2930,3032,39363,3719,-1979,5698,0,86162,76707,9455,3719,13174,192,0,12982,1713,185,14880,23023
"798",1986,"Benton",22345,13646,304921,915,95,0.0191,5.97,130909,20421,16091,4330,130273,12818,18871,4370,12925,82999,4824,5355,71110,9767,-2279,12046,0,151330,130273,21057,9767,30824,2039,NA,28784,3121,323,32228,47910
"799",1986,"Black Hawk",126207,12814,1617162,1010,100,0.0191,5.97,97347,19992,15686,4306,96512,11568,8132,3626,9515,54610,3648,5372,54651,4328,-1284,5612,0,117339,96512,20827,4328,25155,2869,0,22286,3253,335,25874,42737
"800",1986,"Boone",25316,14346,363185,987,92,0.0191,5.97,83121,14066,11830,2236,84474,7040,8700,3607,9165,38615,3182,4177,48603,9689,-1132,10821,0,97187,84474,12713,9689,22402,2740,0,19662,2864,271,22797,44506
"801",1986,"Bremer",23226,12698,294931,861,90,0.0191,5.97,74533,12653,10154,2499,77513,8703,6272,2985,7730,47354,3105,3107,45611,2605,-1208,3813,0,87186,77513,9673,2605,12278,631,0,11647,1586,177,13410,27179
"802",1986,"Buchanan",21079,11641,245383,883,87,0.0191,5.97,103913,18461,15871,2590,104712,11720,10215,3921,11528,66659,4242,4267,58819,-1430,-2080,650,0,122374,104712,17662,-1430,16232,876,0,15356,2596,271,18223,37254
"803",1986,"Buena Vista",20406,13885,283336,974,92,0.0191,5.97,126642,17288,14221,3067,121408,22291,16556,3654,9223,83980,3943,6153,59588,10093,-1825,11918,0,143930,121408,22522,10093,32615,1929,0,30686,3978,387,35051,42662
"804",1986,"Butler",16324,12535,204620,921,88,0.0191,5.97,104326,17406,14348,3058,103107,13814,11728,3634,10042,66196,3878,4634,55377,4327,-1559,5886,0,121732,103107,18625,4327,22952,1498,0,21454,2467,253,24174,38130
"805",1986,"Calhoun",11953,13619,162790,1006,96,0.0191,5.97,87269,17199,14358,2841,89103,10097,11894,3295,8503,43512,3128,3304,48882,12611,-1226,13837,0,104468,89103,15365,12611,27976,960,0,27016,1984,195,29195,43757
"806",1986,"Carroll",22097,14003,309434,891,91,0.0191,5.97,155207,16916,12898,4018,144831,22912,36832,3440,8536,114475,4484,5480,63147,5538,-3381,8919,0,172123,144831,27292,5538,32830,1557,NA,31272,3449,351,35072,40732
"807",1986,"Cass",15840,13516,214089,668,NA,0.0191,5.97,74873,12607,10165,2442,79414,7458,13021,2877,7061,45982,3093,3061,42843,4518,-1736,6254,0,87480,79414,8066,4518,12584,450,0,12134,1715,173,14022,28891
"808",1986,"Cedar",17823,13516,240895,1105,113,0.0191,5.97,101883,20404,16500,3904,109351,11897,12989,3959,10878,63528,3896,4101,61631,1212,-1761,2973,0,122287,109351,12936,1212,14148,1274,0,12874,2432,253,15559,38355
"809",1986,"Cerro Gordo",48158,13843,666653,957,85,0.0191,5.97,86095,19948,17469,2479,86853,8659,4210,3446,9515,40797,4078,4326,52619,7569,-1102,8671,0,106043,86853,19190,7569,26759,2214,0,24545,2324,238,27107,45298
"810",1986,"Cherokee",14843,13322,197735,832,NA,0.0191,5.97,112696,14864,11731,3133,110972,12804,22259,3202,7605,76473,3537,4399,57166,8098,-2843,10941,0,127560,110972,16588,8098,24686,960,0,23726,2300,233,26259,36223
"811",1986,"Chickasaw",14174,12645,179228,715,75,0.0191,5.97,80714,15747,12537,3210,82717,8771,9784,3209,8769,52959,3540,3327,45317,291,-1508,1799,0,96461,82717,13744,291,14035,721,0,13314,2019,209,15542,27755
"812",1986,"Clarke",8287,11775,97578,399,52,0.0191,5.97,25846,5279,3967,1312,29662,2705,1915,1154,2824,18355,1474,988,18602,2550,-1134,3684,0,31125,29662,1463,2550,4013,91,0,3922,481,52,4455,7491
"813",1986,"Clay",17771,13877,246602,893,82,0.0191,5.97,88722,16169,13303,2866,90221,10575,13806,3208,8024,52441,3254,3488,47866,11306,-1254,12560,0,104891,90221,14670,11306,25976,1729,0,24247,2093,215,26555,36281
"814",1986,"Clayton",19699,12286,242018,604,NA,0.0191,5.97,147390,19901,14349,5552,133232,19708,10177,3693,9416,126260,5272,5650,79316,2001,-3654,5655,0,167291,133232,34059,2001,36060,1071,NA,34988,3174,351,38513,21130
"815",1986,"Clinton",52449,13103,687217,918,125,0.0191,5.97,113269,24693,20478,4215,120957,10989,16589,4305,12951,71706,4491,5196,66436,-2590,-2873,283,0,137962,120957,17005,-2590,14415,1026,0,13389,2957,318,16664,41563
"816",1986,"Crawford",17743,12500,221781,763,NA,0.0191,5.97,104966,16961,13443,3518,109015,12825,17371,3407,8646,69618,4019,4528,58219,4818,-3064,7882,0,121927,109015,12912,4818,17730,813,0,16917,2568,267,19752,35348
"817",1986,"Dallas",28879,14904,430410,768,88,0.0191,5.97,69066,15499,11665,3834,80358,4515,6547,3051,7875,29973,2790,3672,51908,8851,-1139,9990,0,84565,80358,4207,8851,13058,1323,0,11735,2242,229,14206,39093
"818",1986,"Davis",8686,10647,92478,440,NA,0.0191,5.97,33391,5846,4331,1515,36896,4662,2881,1378,3619,23267,1609,1143,21604,4158,-1248,5406,0,39237,36896,2341,4158,6499,170,0,6329,595,68,6992,10124
"819",1986,"Decatur",8779,10393,91239,326,57,0.0191,5.97,34338,4661,3563,1098,36819,3795,4657,1014,3217,23014,1509,1515,21112,3315,-1372,4687,0,38999,36819,2180,3315,5495,309,0,5186,942,95,6223,11324
"820",1986,"Delaware",18060,12937,233648,957,NA,0.0191,5.97,169582,22724,18456,4268,150203,28136,14212,3856,10926,145209,6040,6053,80980,811,-3511,4322,0,192306,150203,42103,811,42914,1938,NA,40975,3781,414,45170,24373
"821",1986,"Des Moines",43222,14157,611891,781,136,0.0191,5.97,50340,10332,7468,2864,46042,3723,2871,2028,5488,19473,1852,2178,27902,319,-821,1140,0,60672,46042,14630,319,14949,1251,0,13698,1276,138,15112,30867
"822",1986,"Dickinson",14813,14415,213536,793,74,0.0191,5.97,60690,11092,8423,2669,61128,7125,10923,1928,4897,36053,2093,2363,31799,4903,-1112,6015,0,71782,61128,10654,4903,15557,1169,0,14388,1575,160,16123,24637
"823",1986,"Dubuque",87771,13345,1171304,841,NA,0.0191,5.97,159728,13271,9931,3340,137416,23587,17974,2957,7491,147936,5157,6732,73518,-1266,-3781,2515,0,172999,137416,35583,-1266,34317,759,NA,33557,4231,478,38266,11792
"824",1986,"Emmet",11897,12901,153487,919,90,0.0191,5.97,54926,13176,11016,2160,56910,3828,5822,2278,5751,23233,2360,1912,34959,6842,-869,7711,0,68102,56910,11192,6842,18034,741,0,17293,1080,112,18485,31693
"825",1986,"Fayette",22602,11871,268301,820,NA,0.0191,5.97,133436,22164,18155,4009,132361,16272,12544,4270,11879,94127,5197,6427,75772,-242,-2915,2673,0,155600,132361,23239,-242,22997,1568,NA,21428,3810,409,25647,39309
"826",1986,"Floyd",17882,13025,232920,862,80,0.0191,5.97,76877,15251,12401,2850,76535,6911,6732,3217,8108,34841,3425,3832,44310,7245,-980,8225,0,92128,76535,15593,7245,22838,2237,0,20601,2475,252,23328,42036
"827",1986,"Franklin",12100,14238,172274,965,95,0.0191,5.97,112243,21578,18564,3014,108384,13326,10664,3907,10633,64044,4022,5306,60526,11692,-1519,13211,0,133821,108384,25437,11692,37129,2326,0,34803,2927,297,38027,48199
"828",1986,"Fremont",8667,14256,123561,683,NA,0.0191,5.97,64549,11251,9030,2221,62150,4895,8592,2562,5540,27497,2365,3364,34832,10331,-876,11207,0,75800,62150,13650,10331,23981,1723,0,22258,2257,223,24738,37052
"829",1986,"Greene",10824,14142,153071,890,95,0.0191,5.97,77402,17182,13536,3646,85192,6631,6952,3462,8989,32227,3266,4541,51351,14257,-1225,15482,0,94584,85192,9392,14257,23649,2053,0,21596,2552,248,24396,45175
"830",1986,"Grundy",12799,14292,182926,1047,101,0.0191,5.97,105965,17967,14344,3623,110546,11654,16447,3518,10603,61307,3841,5564,58919,12172,-1374,13546,0,123932,110546,13386,12172,25558,3655,0,21903,3172,315,25390,44658
"831",1986,"Guthrie",11277,12975,146318,671,75,0.0191,5.97,61499,12812,8737,4075,64078,5858,6566,2011,6191,36310,2717,2517,38218,3086,-1858,4944,0,74311,64078,10233,3086,13319,527,0,12792,1275,148,14215,25189
"832",1986,"Hamilton",16832,14917,251075,1068,95,0.0191,5.97,124190,19498,16143,3355,124631,24471,14254,3575,9525,76390,4409,5826,62571,9568,-1330,10898,0,143688,124631,19057,9568,28625,2178,0,26447,3967,393,30807,47800
"833",1986,"Hancock",13095,14665,192040,962,91,0.0191,5.97,100613,19697,16799,2898,97962,10099,9386,3850,10024,52673,4187,4055,56361,9993,-1308,11301,0,120310,97962,22348,9993,32341,1563,0,30778,2424,239,33441,47940
"834",1986,"Hardin",20275,14303,290001,994,103,0.0191,5.97,116339,21316,17437,3879,114846,13775,15257,4003,10508,69365,3890,5441,61972,7507,-2380,9887,0,137655,114846,22809,7507,30316,2317,0,27999,3278,339,31616,46974
"835",1986,"Harrison",15345,12226,187609,647,NA,0.0191,5.97,71131,12423,10512,1911,72256,4810,6929,3198,8803,30725,3024,3382,42110,6380,-1211,7591,0,83554,72256,11298,6380,17678,826,0,16852,2098,216,19166,40406
"836",1986,"Henry",18965,13260,251483,738,125,0.0191,5.97,56301,12069,9313,2756,62219,8929,4609,2087,6218,33684,2243,2574,35559,4234,-1052,5286,0,68370,62219,6151,4234,10385,691,0,9694,1648,162,11504,22617
"837",1986,"Howard",10290,12752,131223,625,NA,0.0191,5.97,67428,13594,11058,2536,67555,7598,5310,2579,7187,42868,3117,3287,38477,4298,-1391,5689,0,81022,67555,13467,4298,17765,615,0,17150,1773,187,19110,24560
"838",1986,"Humboldt",11273,13545,152689,1042,94,0.0191,5.97,70708,14024,12170,1854,74145,5947,8930,2925,7389,34496,2632,2918,43404,8312,-796,9108,0,84732,74145,10587,8312,18899,652,0,18247,1819,182,20248,36212
"839",1986,"Ida",8597,13343,114708,848,NA,0.0191,5.97,76179,11952,9982,1970,75401,7733,14921,2484,6436,50360,2495,3262,38070,4637,-2243,6880,0,88131,75401,12730,4637,17367,553,0,16814,1768,175,18757,25819
"840",1986,"Iowa",14920,13710,204554,773,87,0.0191,5.97,86802,15156,12781,2375,90059,11280,11461,3025,8523,57018,3287,4120,48363,-1497,-2345,848,0,101958,90059,11899,-1497,10402,835,0,9567,2567,260,12394,29784
"841",1986,"Jackson",21119,11549,243910,776,NA,0.0191,5.97,86164,12622,10321,2301,89665,11235,14232,2223,6213,72578,3333,3857,48572,-2109,-2263,154,0,98786,89665,9121,-2109,7012,229,0,6783,2359,281,9423,13586
"842",1986,"Jasper",34638,14858,514660,831,97,0.0191,5.97,117584,17289,13478,3811,110117,13946,12286,4092,10613,78389,4133,5029,60018,7475,-2772,10247,0,134873,110117,24756,7475,32231,2446,0,29785,3100,309,33194,39195
"843",1986,"Jefferson",16270,13000,211504,554,NA,0.0191,5.97,46591,9649,7811,1838,45659,4099,3555,1857,5691,25731,2171,1914,26372,4247,-1134,5381,0,56240,45659,10581,4247,14828,936,0,13892,1127,113,15132,20860
"844",1986,"Johnson",89404,14483,1294804,1000,100,0.0191,5.97,100260,14038,10741,3297,94948,16104,8773,3034,8714,73904,3552,4280,50491,-279,-2335,2056,0,114298,94948,19350,-279,19071,1336,0,17735,2576,254,20565,26356
"845",1986,"Jones",19347,11533,223127,832,103,0.0191,5.97,106240,16831,13939,2892,109707,14609,17924,3291,9523,80179,3875,4559,55926,-474,-2359,1885,0,123071,109707,13364,-474,12890,1167,0,11723,2632,283,14638,26061
"846",1986,"Keokuk",12124,13433,162865,691,NA,0.0191,5.97,84181,15886,13716,2170,82945,10630,6405,3078,9832,54977,3755,3160,46085,562,-2223,2785,0,100067,82945,17122,562,17684,872,0,16812,2011,201,19024,29204
"847",1986,"Kossuth",19684,14367,282809,966,92,0.0191,5.97,168353,33550,27661,5889,168107,16847,15715,6457,16491,84500,7381,6572,98644,25927,-2063,27990,0,201903,168107,33796,25927,59723,2344,NA,57378,4038,417,61833,83853
"848",1986,"Lee",40317,13345,538014,657,119,0.0191,5.97,60392,8281,6348,1933,56848,7332,6190,2071,6206,40358,2298,2238,30513,3035,-1343,4378,0,68673,56848,11825,3035,14860,1077,0,13783,1486,165,15434,20034
"849",1986,"Linn",164173,15741,2584275,1056,98,0.0191,5.97,86468,19437,15740,3697,101184,8571,9321,4013,9940,48889,4002,5369,59968,5361,-1288,6649,0,105905,101184,4721,5361,10082,861,0,9221,3145,309,12675,37579
"850",1986,"Louisa",11625,12910,150082,904,129,0.0191,5.97,48348,11712,10201,1511,48814,3829,2494,2137,5978,21846,2053,2304,30019,2280,-787,3067,0,60060,48814,11246,2280,13526,1129,0,12397,1385,136,13918,26502
"851",1986,"Lucas",9546,12949,123608,382,NA,0.0191,5.97,22840,4470,2983,1487,27579,3143,1689,948,2458,15615,1217,1080,17044,2443,-1087,3530,0,27310,27579,-269,2443,2174,73,0,2101,505,54,2660,7225
"852",1986,"Lyon",12074,12616,152331,814,78,0.0191,5.97,129785,15670,11205,4465,118048,17541,26348,3315,7564,95318,3779,3966,55535,6569,-2718,9287,0,145455,118048,27407,6569,33976,1908,0,32068,2418,255,34741,34467
"853",1986,"Madison",12235,13400,163950,577,64,0.0191,5.97,55284,8035,6166,1869,57671,8249,4189,1782,4610,35702,2097,3045,33699,3180,-1738,4918,0,63319,57671,5648,3180,8828,394,0,8434,1989,191,10614,19582
"854",1986,"Mahaska",21637,13157,284683,681,NA,0.0191,5.97,110838,13408,10203,3205,100269,15067,14528,3107,8148,82054,3610,4668,51141,5433,-2792,8225,0,124246,100269,23977,5433,29410,1178,0,28232,2997,296,31525,28784
"855",1986,"Marion",29455,14343,422469,654,NA,0.0191,5.97,63067,8815,6294,2521,60768,7561,4812,2464,5360,40384,2522,3424,34625,3749,-1709,5458,0,71882,60768,11114,3749,14863,693,0,14170,2168,215,16553,22683
"856",1986,"Marshall",39653,14415,571586,877,89,0.0191,5.97,81176,18818,14758,4060,86188,8179,8947,3495,8830,40759,3519,4948,48270,7070,-1386,8456,0,99994,86188,13806,7070,20876,2242,0,18634,3297,329,22260,40417
"857",1986,"Mills",13230,15327,202776,702,NA,0.0191,5.97,51409,11064,8159,2905,52595,4333,6946,2066,5600,23108,1963,2584,29103,8929,-932,9861,0,62473,52595,9878,8929,18807,1100,0,17707,1280,130,19117,28301
"858",1986,"Mitchell",11261,14874,167500,829,70,0.0191,5.97,93136,14869,11615,3254,87377,13132,11372,2936,7422,63334,3402,3897,45216,3899,-1516,5415,0,108005,87377,20628,3899,24527,938,0,23589,2144,220,25953,29802
"859",1986,"Monona",10529,12696,133679,632,NA,0.0191,5.97,69372,16232,12986,3246,71877,4357,9216,3073,8601,32569,2863,3051,40716,6087,-1615,7702,0,85604,71877,13727,6087,19814,655,0,19159,1671,173,21003,36803
"860",1986,"Monroe",8359,11994,100261,427,NA,0.0191,5.97,25636,3554,2444,1110,31410,3582,3835,973,2682,19485,1343,1174,17821,1987,-1509,3496,0,29190,31410,-2220,1987,-233,NA,0,-228,619,66,457,6151
"861",1986,"Montgomery",12345,13795,170301,643,NA,0.0191,5.97,51489,9507,7577,1930,53811,4685,7226,2161,5540,25327,2359,2597,29243,6727,-1155,7882,0,60996,53811,7185,6727,13912,437,0,13475,1494,155,15124,26162
"862",1986,"Muscatine",40026,14865,594984,990,118,0.0191,5.97,59932,11738,9702,2036,63223,5860,4968,2316,6966,32296,2610,3083,37420,1041,-1058,2099,0,71670,63223,8447,1041,9488,923,0,8565,2030,205,10800,27636
"863",1986,"O'Brien",15925,14233,226657,1026,89,0.0191,5.97,147967,18295,14122,4173,135466,20433,28943,3985,10044,101877,4163,4670,63228,9365,-2544,11909,0,166262,135466,30796,9365,40161,2175,NA,37985,2786,281,41052,46090
"864",1986,"Osceola",7537,12591,94897,895,83,0.0191,5.97,67570,13009,11222,1787,71083,9127,11059,2450,5798,40786,2734,2526,37389,6248,-1163,7411,0,80579,71083,9496,6248,15744,1084,0,14660,1401,144,16205,26784
"865",1986,"Page",17303,13888,240312,575,NA,0.0191,5.97,76754,9880,6924,2956,70839,5737,7814,3866,5780,36699,2439,5405,39798,7759,-1554,9313,0,86634,70839,15795,7759,23554,923,0,22631,3634,355,26620,40055
"866",1986,"Palo Alto",11369,13420,152567,887,90,0.0191,5.97,87090,19119,15266,3853,90263,8340,9648,3493,9041,42871,3524,3833,52384,10236,-1168,11404,0,106209,90263,15946,10236,26182,1718,0,24464,2172,217,26853,44219
"867",1986,"Plymouth",23599,13166,310695,833,NA,0.0191,5.97,175065,20705,15478,5227,161902,23744,32947,4622,11575,129456,5317,5798,77899,6278,-3849,10127,0,195770,161902,33868,6278,40146,1357,NA,38788,3056,329,42173,45609
"868",1986,"Pocahontas",10369,14377,149075,995,91,0.0191,5.97,93407,19462,16512,2950,91799,9436,9766,3524,8437,46815,3341,2796,54499,12326,-1211,13537,0,112869,91799,21070,12326,33396,1840,0,31556,1782,183,33521,46592
"869",1986,"Polk",309714,16774,5195297,886,99,0.0191,5.97,47420,10753,8792,1961,54595,2653,2596,2766,6582,16175,2184,3555,34259,7850,-546,8396,0,58173,54595,3578,7850,11428,1281,0,10147,2221,223,12591,31245
"870",1986,"Pottawattamie",84181,13508,1137087,702,NA,0.0191,5.97,142032,23117,18235,4882,146796,11590,25159,5172,14230,76606,5646,6319,78680,9791,-2838,12629,0,165149,146796,18353,9791,28144,1919,NA,26224,4029,393,30646,65426
"871",1986,"Poweshiek",18702,14206,265689,785,95,0.0191,5.97,74732,13545,11302,2243,78555,7785,7002,2909,7786,47018,3198,3232,46643,8017,-2376,10393,0,88277,78555,9722,8017,17739,596,0,17143,1935,206,19284,27714
"872",1986,"Ringgold",5568,12244,68173,388,53,0.0191,5.97,36684,6197,4767,1430,39326,3951,3439,1200,3535,25314,1706,1661,23834,4908,-1861,6769,0,42881,39326,3555,4908,8463,246,0,8217,950,102,9269,11370
"873",1986,"Sac",12746,14019,178690,930,NA,0.0191,5.97,128232,16227,12641,3586,120380,16179,23096,3434,8760,88933,3932,6139,58840,11186,-2677,13863,0,144459,120380,24079,11186,35265,1958,0,33307,3909,380,37596,39299
"874",1986,"Scott",152609,14844,2265299,1376,143,0.0191,5.97,79540,14238,11380,2858,84258,9183,9738,3156,8465,49514,3357,3329,47030,-1033,-1401,368,0,93778,84258,9520,-1033,8487,973,0,7514,2145,240,9899,30026
"875",1986,"Shelby",13799,12759,176062,725,NA,0.0191,5.97,99528,16879,14271,2608,100788,12096,16084,3222,8953,61127,3818,3273,53342,2447,-2548,4995,0,116407,100788,15619,2447,18066,713,0,17353,1904,193,19450,38401
"876",1986,"Sioux",29895,12700,379659,900,85,0.0191,5.97,328337,26779,18925,7854,293339,58681,92568,5523,13685,279329,6468,10942,105472,2783,-5331,8114,0,355116,293339,61777,2783,64560,2480,NA,62079,7169,714,69962,49008
"877",1986,"Story",74022,12985,961201,1019,93,0.0191,5.97,94099,19800,15662,4138,94584,10277,10084,3473,9072,49793,3474,5483,52721,8855,-1101,9956,0,113899,94584,19315,8855,28170,3249,0,24921,3506,341,28768,44306
"878",1986,"Tama",18219,13495,245859,828,102,0.0191,5.97,97419,19383,16054,3329,104843,10311,9226,4207,11239,52562,4240,4805,60815,7742,-2025,9767,0,116802,104843,11959,7742,19701,1051,0,18650,2940,292,21882,44857
"879",1986,"Taylor",7590,11773,89360,446,61,0.0191,5.97,40506,7533,5707,1826,41210,4251,2922,1455,3884,23964,1940,1672,25086,5804,-1419,7223,0,48039,41210,6829,5804,12633,438,0,12195,899,100,13194,16542
"880",1986,"Union",12927,12638,163377,466,59,0.0191,5.97,34044,6171,4767,1404,38762,4487,5720,1139,3074,23768,1485,1757,21100,1454,-1630,3084,0,40215,38762,1453,1454,2907,109,0,2798,996,119,3913,10276
"881",1986,"Van Buren",7991,10841,86633,483,NA,0.0191,5.97,32091,6055,4829,1226,36298,3871,2353,1338,4156,19682,1450,1697,21433,3434,-1055,4489,0,38146,36298,1848,3434,5282,193,0,5089,1040,103,6232,12409
"882",1986,"Wapello",37135,12222,453870,500,NA,0.0191,5.97,34251,6216,4733,1483,38414,3466,3432,1349,4096,19350,1666,1577,22828,4460,-1023,5483,0,40467,38414,2053,4460,6513,302,0,6211,897,93,7201,14901
"883",1986,"Warren",34899,13119,457852,636,71,0.0191,5.97,53348,8405,5991,2414,56419,5997,4397,2060,5126,32144,2355,3077,33407,1042,-1503,2545,0,61753,56419,5334,1042,6376,395,0,5981,1914,205,8100,21204
"884",1986,"Washington",19620,14146,277550,899,108,0.0191,5.97,119571,17191,14396,2795,105010,20823,9132,3151,9066,87429,4100,4642,54096,-444,-2415,1971,0,136762,105010,31752,-444,31308,3496,0,27812,3285,325,31422,32142
"885",1986,"Wayne",7361,12483,91884,377,NA,0.0191,5.97,34152,6933,5396,1537,37070,3019,3561,1254,3621,20307,1648,1286,22681,4536,-1581,6117,0,41085,37070,4015,4536,8551,162,0,8389,567,62,9018,13845
"886",1986,"Webster",41681,13381,557753,1041,96,0.0191,5.97,99198,22027,18283,3744,109083,12140,5244,4036,10766,40316,4042,5398,67457,17868,-938,18806,0,121225,109083,12142,17868,30010,1502,0,28508,3815,380,32703,58882
"887",1986,"Winnebago",12314,14543,179086,872,82,0.0191,5.97,56193,16184,14279,1905,60094,4507,3924,2658,6715,23644,2759,2090,37441,6089,-491,6580,0,72377,60094,12283,6089,18372,1486,0,16886,1136,124,18146,32549
"888",1986,"Winneshiek",21135,12226,258393,642,NA,0.0191,5.97,128532,15982,11577,4405,114594,15417,11477,3045,7555,110439,4710,5302,67088,-3096,-3549,453,0,144514,114594,29920,-3096,26824,445,0,26379,2943,337,29659,18093
"889",1986,"Woodbury",97532,13782,1344172,691,NA,0.0191,5.97,114087,21786,17392,4394,122861,13399,24259,3996,11761,74662,3998,5127,60321,-590,-3734,3144,0,135873,122861,13012,-590,12422,366,0,12056,2571,268,14895,39425
"890",1986,"Worth",8472,13213,111944,871,79,0.0191,5.97,54914,14558,12679,1879,58739,6243,5629,2415,6597,27231,2591,1987,33277,5588,-529,6117,0,69472,58739,10733,5588,16321,495,0,15826,1147,123,17096,27683
"891",1986,"Wright",14833,14576,216202,1055,93,0.0191,5.97,78193,20029,16402,3627,86940,5908,6338,3928,9576,29323,3341,3854,53995,15514,-756,16270,0,98222,86940,11282,15514,26796,1697,0,25099,2267,228,27594,48870
"892",1987,"Adair",8550,13335,114014,557,68,0.0366,5.78,78505,19811,16801,3010,74231,7678,8463,2846,6829,43509,2502,2621,43292,-8404,385,-8789,0,98316,74231,24085,-8404,15681,928,0,14753,1228,161,16142,34996
"893",1987,"Adams",5217,13141,68558,578,67,0.0366,5.78,43946,11631,10489,1142,38887,3206,4027,1518,3657,25347,1699,1703,23077,-4726,242,-4968,0,55577,38887,16690,-4726,11964,455,0,11509,780,122,12411,18599
"894",1987,"Allamakee",14160,12705,179907,532,74,0.0366,5.78,86662,15586,13806,1780,76350,10071,6964,1770,4140,75718,2791,3629,46985,-5158,473,-5631,0,102248,76350,25898,-5158,20740,389,0,20351,2234,317,22902,10944
"895",1987,"Appanoose",14116,11248,158778,373,NA,0.0366,5.78,27533,7260,6430,830,27624,1870,3188,868,2495,16892,1228,1108,16867,-2833,-130,-2703,0,34793,27624,7169,-2833,4336,121,0,4215,575,84,4874,10641
"896",1987,"Audubon",7605,13952,106102,850,82,0.0366,5.78,88843,20033,17483,2550,77851,10137,14531,2340,6251,55596,2670,2996,38926,-8565,861,-9426,0,108876,77851,31025,-8565,22460,355,0,22105,1631,228,23964,33247
"897",1987,"Benton",22214,14068,312517,1004,86,0.0366,5.78,155815,28341,24859,3482,137512,13195,25695,4319,12092,87813,4415,5624,72172,-15223,1102,-16325,0,184156,137512,46644,-15223,31421,2158,NA,29262,3002,405,32669,68002
"898",1987,"Black Hawk",123818,13782,1706471,1095,87,0.0366,5.78,112801,25336,21656,3680,97961,12520,10302,3500,8917,55654,3333,5547,53842,-11646,1262,-12908,0,138137,97961,40176,-11646,28530,3290,0,25240,3106,418,28764,57147
"899",1987,"Boone",25154,15279,384322,1094,80,0.0366,5.78,102773,22694,21108,1586,86861,6888,10824,3610,8782,40372,2990,4293,49474,-12041,654,-12695,0,125467,86861,38606,-12041,26565,3457,0,23108,2727,334,26169,62401
"900",1987,"Bremer",22712,13404,304440,931,86,0.0366,5.78,84191,17956,16032,1924,79105,9029,7847,3036,7569,49515,2865,3248,45511,-8289,609,-8898,0,102147,79105,23042,-8289,14753,725,0,14028,1508,228,15764,34676
"901",1987,"Buchanan",20786,13034,270930,953,85,0.0366,5.78,122890,27885,25809,2076,107688,12276,13241,3977,11010,71336,3961,4540,58683,-12256,1428,-13684,0,150775,107688,43087,-12256,30831,1733,0,29098,2585,357,32040,51554
"902",1987,"Buena Vista",20102,14117,283772,1129,81,0.0366,5.78,144859,25137,22867,2270,127557,24185,20778,3577,8519,87106,3606,6236,60656,-11229,1662,-12891,0,169996,127557,42439,-11229,31210,1886,0,29324,3923,475,33722,57753
"903",1987,"Butler",15988,13311,212816,1013,81,0.0366,5.78,118927,26337,23875,2462,107316,14784,15170,3588,9725,70196,3483,4857,55709,-10672,1481,-12153,0,145264,107316,37948,-10672,27276,1831,0,25445,2372,318,28135,48731
"904",1987,"Calhoun",11761,13971,164317,1132,79,0.0366,5.78,110791,25805,23660,2145,93963,9832,13834,3386,8382,44422,2914,3480,52135,-13637,788,-14425,0,136596,93963,42633,-13637,28996,1145,0,27851,2025,249,30125,66369
"905",1987,"Carroll",21772,15091,328566,1014,89,0.0366,5.78,188101,23880,20586,3294,152415,22902,42500,3479,8341,132043,4151,5746,65296,-11464,1904,-13368,0,211981,152415,59566,-11464,48102,2297,NA,45804,3403,446,49653,56058
"906",1987,"Cass",15415,14031,216287,748,73,0.0366,5.78,91375,20749,18638,2111,83767,7585,16249,2928,6703,50519,2831,3154,44317,-9726,515,-10241,0,112124,83767,28357,-9726,18631,672,0,17959,1665,216,19840,40856
"907",1987,"Cedar",17476,14735,257504,1184,104,0.0366,5.78,118052,30697,27369,3328,112368,12480,16836,3888,10115,70903,3447,4015,61587,-9887,1574,-11461,0,148749,112368,36381,-9887,26494,2367,0,24127,2097,297,26521,47149
"908",1987,"Cerro Gordo",47357,14762,699095,1063,80,0.0366,5.78,94845,31483,29425,2058,84723,8691,4624,3355,8655,37677,3755,4430,51213,-11294,950,-12244,0,126328,84723,41605,-11294,30311,2621,0,27690,2186,294,30170,57168
"909",1987,"Cherokee",14507,14102,204584,950,79,0.0366,5.78,131972,23730,21191,2539,115254,12958,26670,3290,7534,84914,3324,4733,56745,-9779,1181,-10960,0,155702,115254,40448,-9779,30669,1282,0,29387,2282,296,31965,47058
"910",1987,"Chickasaw",13716,14014,192211,774,73,0.0366,5.78,94656,24524,21441,3083,87447,9119,13146,3304,8499,58287,3243,3434,46702,-8976,874,-9850,0,119180,87447,31733,-8976,22757,1181,0,21576,1995,265,23836,36369
"911",1987,"Clarke",8349,12328,102927,429,34,0.0366,5.78,30072,10591,9590,1001,30429,2923,2403,1220,2872,19903,1442,988,18581,-2972,113,-3085,0,40663,30429,10234,-2972,7262,166,0,7096,410,62,7568,10169
"912",1987,"Clay",17315,14791,256103,1035,71,0.0366,5.78,103668,25451,23196,2255,91658,10677,16749,3149,7421,51917,2919,3390,47353,-10840,817,-11657,0,129119,91658,37461,-10840,26621,1861,0,24760,1897,259,26916,51751
"913",1987,"Clayton",19411,13090,254084,666,82,0.0366,5.78,164049,29205,23724,5481,138671,20826,13212,3655,8968,137964,4773,5887,81350,-9655,1784,-11439,0,193254,138671,54583,-9655,44928,1448,NA,43479,3173,465,47117,26085
"914",1987,"Clinton",51722,13877,717758,985,95,0.0366,5.78,127265,35568,32274,3294,120466,10812,19577,4234,11924,79297,3963,5157,64799,-11648,984,-12632,0,162833,120466,42367,-11648,30719,2330,0,28389,2606,386,31381,47968
"915",1987,"Crawford",17613,13036,229607,868,74,0.0366,5.78,122079,25478,22943,2535,114322,13138,21721,3493,8338,73775,3711,4818,59103,-10910,1042,-11952,0,147557,114322,33235,-10910,22325,1075,0,21250,2626,353,24229,48304
"916",1987,"Dallas",28807,15779,454556,854,79,0.0366,5.78,86459,24365,21088,3277,81233,4651,7245,2957,7399,30795,2538,3834,52609,-11577,410,-11987,0,110824,81233,29591,-11577,18014,1942,0,16072,2160,293,18525,55664
"917",1987,"Davis",8554,11095,94904,475,NA,0.0366,5.78,36419,11668,10407,1261,37912,4864,3797,1409,3485,24734,1522,1129,21706,-3219,212,-3431,0,48087,37912,10175,-3219,6956,199,0,6757,536,87,7380,11685
"918",1987,"Decatur",8558,10860,92944,347,52,0.0366,5.78,38967,9302,8507,795,38958,4308,6089,1093,3249,26142,1474,1576,21169,-3371,95,-3466,0,48269,38958,9311,-3371,5940,357,0,5583,876,115,6574,12825
"919",1987,"Delaware",17926,14107,252887,1043,87,0.0366,5.78,192620,28919,25207,3712,156193,30903,18843,3835,10403,161103,5669,6229,80311,-9158,3456,-12614,0,221539,156193,65346,-9158,56188,2669,NA,53518,3781,541,57840,31517
"920",1987,"Des Moines",42948,14887,639380,854,NA,0.0366,5.78,49384,15176,12404,2772,46762,3593,3379,1980,5219,20196,1608,2170,28813,-5356,284,-5640,0,64560,46762,17798,-5356,12442,1093,0,11349,1007,157,12513,29188
"921",1987,"Dickinson",14656,15495,227090,908,72,0.0366,5.78,70434,17700,15059,2641,62122,6440,12832,1870,4579,37538,1907,2350,32144,-6894,408,-7302,0,88134,62122,26012,-6894,19118,1522,0,17596,1475,193,19264,32896
"922",1987,"Dubuque",87125,14530,1265955,924,86,0.0366,5.78,172745,21375,18498,2877,144996,25484,23817,2944,7284,158232,4921,7090,73456,-6678,1880,-8558,0,194120,144996,49124,-6678,42446,1040,NA,41405,4427,646,46478,14513
"923",1987,"Emmet",11650,13438,156554,1065,87,0.0366,5.78,64209,21116,19195,1921,57975,3933,6784,2218,5425,23108,2143,1956,35516,-8957,382,-9339,0,85325,57975,27350,-8957,18393,762,0,17631,1037,138,18806,41101
"924",1987,"Fayette",21997,12884,283413,895,79,0.0366,5.78,152463,33744,30403,3341,132920,16613,14971,4190,11253,99418,4629,6483,74781,-13053,1321,-14374,0,186207,132920,53287,-13053,40234,2808,NA,37425,3661,518,41604,53045
"925",1987,"Floyd",17538,13903,243834,924,76,0.0366,5.78,90103,25349,23086,2263,76985,7494,8354,3208,7539,37711,3076,3791,43523,-10289,747,-11036,0,115452,76985,38467,-10289,28178,2861,0,25317,2239,299,27855,52392
"926",1987,"Franklin",11795,14531,171394,1113,87,0.0366,5.78,125506,31311,29017,2294,108262,13515,11992,3780,10102,61381,3679,5384,59810,-12950,1346,-14296,0,156817,108262,48555,-12950,35605,2220,0,33385,2681,350,36416,64125
"927",1987,"Fremont",8672,13310,115422,760,NA,0.0366,5.78,75490,17890,16144,1746,71033,5063,10554,2830,5794,32604,2447,3822,40523,-8684,324,-9008,0,93380,71033,22347,-8684,13663,1008,0,12655,2209,274,15138,42886
"928",1987,"Greene",10521,14751,155191,995,89,0.0366,5.78,102143,24444,21461,2983,86946,6343,7661,3422,8672,34522,3107,4736,53005,-13269,570,-13839,0,126587,86946,39641,-13269,26372,2335,0,24037,2447,305,26789,67621
"929",1987,"Grundy",12423,15340,190573,1149,93,0.0366,5.78,134334,26746,23961,2785,117820,11950,21418,3561,10439,69695,3729,5726,60997,-13148,1049,-14197,0,161080,117820,43260,-13148,30112,4401,0,25711,2921,377,29009,64639
"930",1987,"Guthrie",11049,14082,155597,754,66,0.0366,5.78,72577,21660,17718,3942,64514,5376,7257,2000,5782,37549,2555,2554,38990,-8345,548,-8893,0,94237,64514,29723,-8345,21378,918,0,20460,1131,184,21775,35028
"931",1987,"Hamilton",16571,15298,253498,1211,90,0.0366,5.78,140798,28356,25492,2864,128508,24945,17493,3517,8837,75224,3989,5877,63850,-12324,1456,-13780,0,169154,128508,40646,-12324,28322,2336,0,25986,3930,489,30405,65574
"932",1987,"Hancock",12897,14339,184924,1105,88,0.0366,5.78,110537,29443,27197,2246,103891,10318,12016,3882,9918,50650,3847,4364,59546,-12313,1223,-13536,0,139980,103891,36089,-12313,23776,1177,0,22599,2455,308,25362,59887
"933",1987,"Hardin",19638,14723,289131,1127,93,0.0366,5.78,131131,29457,26430,3027,115947,14344,18021,3966,9868,69984,3561,5261,60926,-13038,1634,-14672,0,160588,115947,44641,-13038,31603,2351,0,29252,2959,403,32614,61147
"934",1987,"Harrison",15175,12364,187630,728,79,0.0366,5.78,89926,21613,20383,1230,83540,5475,9644,3495,9189,34145,3044,3653,49040,-12749,277,-13026,0,111539,83540,27999,-12749,15250,767,0,14483,1952,257,16692,55781
"935",1987,"Henry",19056,13723,261499,808,NA,0.0366,5.78,61201,17385,14815,2570,62229,8647,5404,2024,5875,35212,2048,2718,35513,-5135,761,-5896,0,78586,62229,16357,-5135,11222,734,0,10488,1585,203,12276,25989
"936",1987,"Howard",10134,13185,133621,676,66,0.0366,5.78,75066,22894,20919,1975,70002,8063,6599,2533,7116,42749,2780,3402,39509,-7697,660,-8357,0,97960,70002,27958,-7697,20261,684,0,19577,1741,238,21556,32317
"937",1987,"Humboldt",10945,14324,156778,1208,92,0.0366,5.78,88262,19946,18344,1602,77412,5945,11080,2907,6921,36325,2345,3071,45143,-10572,710,-11282,0,108208,77412,30796,-10572,20224,723,0,19501,1826,229,21556,51937
"938",1987,"Ida",8380,14190,118915,965,73,0.0366,5.78,87781,18983,17439,1544,78691,7610,17894,2526,6300,54341,2217,3446,38698,-8545,559,-9104,0,106764,78691,28073,-8545,19528,645,0,18883,1805,224,20912,33440
"939",1987,"Iowa",14699,15206,223508,855,87,0.0366,5.78,100988,23078,21259,1819,91286,10985,13447,3040,8057,63256,2976,4269,48512,-8798,1036,-9834,0,124066,91286,32780,-8798,23982,1896,0,22086,2625,336,25047,37732
"940",1987,"Jackson",20805,12639,262949,843,90,0.0366,5.78,101385,20769,19024,1745,95038,12405,18796,2180,5860,85612,3161,3967,48669,-6063,571,-6634,0,122154,95038,27116,-6063,21053,713,0,20340,2286,363,22989,15773
"941",1987,"Jasper",34567,15720,543389,916,81,0.0366,5.78,134202,28661,25608,3053,113341,14326,14619,4046,10112,77018,3781,5049,61408,-13181,1467,-14648,0,162863,113341,49522,-13181,36341,2943,0,33398,2844,370,36612,57184
"942",1987,"Jefferson",16301,13619,222010,606,NA,0.0366,5.78,49915,13710,12178,1532,45679,3967,3980,1837,5458,26449,2077,1988,26372,-5142,545,-5687,0,63625,45679,17946,-5142,12804,855,0,11949,1023,136,13108,23466
"943",1987,"Johnson",90496,15155,1371439,1089,91,0.0366,5.78,105357,21137,18155,2982,97749,16795,11190,3009,8184,73682,3307,4368,50896,-6813,1519,-8332,0,126494,97749,28745,-6813,21932,1585,0,20347,2441,315,23103,31675
"944",1987,"Jones",19031,12423,236429,895,98,0.0366,5.78,121545,25543,23378,2165,115726,15806,24372,3309,8777,90678,3608,4696,55158,-8773,1274,-10047,0,147088,115726,31362,-8773,22589,2143,0,20446,2500,362,23308,30867
"945",1987,"Keokuk",11900,14693,174849,763,NA,0.0366,5.78,96628,25158,23370,1788,82465,10173,7756,3122,9632,58709,3571,3355,44856,-8251,1436,-9687,0,121786,82465,39321,-8251,31070,1641,0,29429,2030,260,31719,37919
"946",1987,"Kossuth",19156,14637,280379,1143,89,0.0366,5.78,195887,52408,46976,5432,170417,16562,18521,6401,15904,81915,6760,6782,99487,-22922,1814,-24736,0,248295,170417,77878,-22922,54956,2109,NA,52846,3968,528,57342,113972
"947",1987,"Lee",39665,13676,542448,711,NA,0.0366,5.78,64310,11604,9750,1854,58691,7348,7665,2105,5975,42536,2088,2219,31291,-4765,725,-5490,0,75914,58691,17223,-4765,12458,914,0,11544,1354,209,13107,21774
"948",1987,"Linn",164332,16754,2753141,1135,87,0.0366,5.78,104551,23331,20197,3134,103440,9204,12257,4052,9204,55377,3757,5679,59287,-10617,850,-11467,0,127882,103440,24442,-10617,13825,1231,0,12594,3074,388,16056,49174
"949",1987,"Louisa",11635,13512,157207,984,NA,0.0366,5.78,49764,16801,15673,1128,48902,3766,3046,2090,5619,21597,1907,2377,30097,-5070,497,-5567,0,66565,48902,17663,-5070,12593,1136,0,11457,1335,169,12961,28167
"950",1987,"Lucas",9385,13508,126776,406,NA,0.0366,5.78,24941,8893,7489,1404,26530,3178,1816,984,2410,16439,1136,1158,15848,-2657,NA,-2688,0,33834,26530,7304,-2657,4647,181,0,4466,510,71,5047,8502
"951",1987,"Lyon",11903,13179,156866,933,77,0.0366,5.78,150253,23501,19441,4060,126278,17880,32889,3341,7386,105769,3549,3909,57324,-10386,1343,-11729,0,173754,126278,47476,-10386,37090,2223,0,34867,2343,328,37538,44484
"952",1987,"Madison",12257,13900,170374,637,70,0.0366,5.78,60600,13221,11714,1507,59604,9156,4662,1785,4419,36276,1908,3452,34222,-5686,366,-6052,0,73821,59604,14217,-5686,8531,430,0,8101,2175,258,10534,24324
"953",1987,"Mahaska",21466,13939,299211,745,NA,0.0366,5.78,126342,21146,18366,2780,105290,14903,18458,3131,8072,85126,3282,4845,52599,-8756,1726,-10482,0,147488,105290,42198,-8756,33442,1444,0,31998,2988,373,35359,41216
"954",1987,"Marion",29592,15211,450113,706,NA,0.0366,5.78,72970,15136,12842,2294,62568,7268,5712,2515,5235,42280,2297,3679,35862,-6116,922,-7038,0,88106,62568,25538,-6116,19422,1045,0,18377,2236,279,20892,30690
"955",1987,"Marshall",38763,15265,591732,971,81,0.0366,5.78,101129,31182,27687,3495,87876,8042,11539,3550,8292,44832,3243,4973,48237,-12730,750,-13480,0,132311,87876,44435,-12730,31705,3419,0,28286,3139,406,31831,56297
"956",1987,"Mills",13208,16369,216197,781,NA,0.0366,5.78,61156,16843,14139,2704,54475,4264,8039,2089,5150,25236,1756,2678,30499,-7934,249,-8183,0,77999,54475,23524,-7934,15590,997,0,14593,1252,165,16010,35920
"957",1987,"Mitchell",11147,15728,175319,888,69,0.0366,5.78,106434,22513,19594,2919,90023,13902,14506,2861,7124,68041,3173,4134,44323,-8450,1058,-9508,0,128947,90023,38924,-8450,30474,1227,0,29247,2194,289,31730,38393
"958",1987,"Monona",10343,12537,129668,715,67,0.0366,5.78,82601,25341,22334,3007,80839,4522,12117,3403,8977,34101,2956,3472,45392,-11494,284,-11778,0,107942,80839,27103,-11494,15609,565,0,15044,1693,224,16961,48500
"959",1987,"Monroe",8247,13028,107443,462,NA,0.0366,5.78,29776,7001,6125,876,31951,3599,4538,1055,2802,21818,1382,1267,17308,-2461,NA,-2506,0,36777,31951,4826,-2461,2365,NA,0,2337,636,91,3064,7958
"960",1987,"Montgomery",12092,14212,171849,716,70,0.0366,5.78,60629,15001,13474,1527,56848,4874,8792,2197,5417,27894,2208,2705,30655,-6771,363,-7134,0,75630,56848,18782,-6771,12011,386,0,11625,1499,201,13325,32735
"961",1987,"Muscatine",39540,15614,617389,1065,91,0.0366,5.78,62941,15716,13813,1903,63239,5713,5708,2285,6501,33266,2344,3038,37650,-5653,640,-6293,0,78657,63239,15418,-5653,9765,937,0,8828,1790,238,10856,29675
"962",1987,"O'Brien",15611,14905,232685,1175,79,0.0366,5.78,173602,27261,23720,3541,143843,20618,35569,4093,9969,112945,4030,4858,64706,-11977,1580,-13557,0,200863,143843,57020,-11977,45043,2537,NA,42505,2672,350,45527,60657
"963",1987,"Osceola",7360,13165,96898,1025,80,0.0366,5.78,83384,18469,17025,1444,74859,9191,13132,2389,5584,43171,2451,2778,39334,-8640,679,-9319,0,101853,74859,26994,-8640,18354,1314,0,17040,1340,183,18563,40213
"964",1987,"Page",16966,13876,235421,640,66,0.0366,5.78,84913,15448,12948,2500,73219,5702,9179,4270,5699,39105,2233,5607,40529,-7495,450,-7945,0,100361,73219,27142,-7495,19647,807,0,18840,3609,440,22889,45808
"965",1987,"Palo Alto",10982,14053,154327,1040,NA,0.0366,5.78,103942,31386,27932,3454,92452,8475,12010,3420,8704,43724,3225,3854,52764,-13048,880,-13928,0,135328,92452,42876,-13048,29828,1981,0,27847,2005,256,30108,60218
"966",1987,"Plymouth",23562,14394,339162,947,76,0.0366,5.78,203981,31872,27414,4458,169978,24185,41975,4582,11021,141896,4707,5897,77611,-14199,2384,-16583,0,235853,169978,65875,-14199,51676,1845,NA,49830,2981,425,53236,62085
"967",1987,"Pocahontas",10013,13871,138892,1159,82,0.0366,5.78,106028,28400,26204,2196,100058,10532,12215,3561,8322,46434,3140,2932,59356,-12490,913,-13403,0,134428,100058,34370,-12490,21880,1223,0,20657,1681,227,22565,59594
"968",1987,"Polk",312846,17640,5518487,977,80,0.0366,5.78,63328,16665,14946,1719,55580,2488,2944,2821,6469,17023,2084,3812,34962,-8761,279,-9040,0,79993,55580,24413,-8761,15652,1798,0,13854,2110,275,16239,46305
"969",1987,"Pottawattamie",83795,14001,1173250,786,78,0.0366,5.78,163990,34313,29931,4382,150353,10711,27812,5217,13522,80989,5201,6688,81202,-19374,721,-20095,0,198303,150353,47950,-19374,28576,2051,NA,26524,3993,500,31017,83001
"970",1987,"Poweshiek",18747,15051,282161,868,86,0.0366,5.78,90663,23345,21633,1712,80781,7748,8439,2927,7481,49679,2921,3309,47956,-9874,715,-10589,0,114008,80781,33227,-9874,23353,784,0,22569,1905,264,24738,40984
"971",1987,"Ringgold",5429,12840,69708,420,60,0.0366,5.78,42612,12864,11610,1254,40830,4171,4170,1257,3419,27635,1615,1801,24397,-3940,174,-4114,0,55476,40830,14646,-3940,10706,324,0,10382,917,129,11428,14977
"972",1987,"Sac",12557,13742,172561,1058,92,0.0366,5.78,144336,24178,20972,3206,124849,15721,28066,3321,8106,91904,3482,6608,59545,-11032,1607,-12639,0,168514,124849,43665,-11032,32633,1863,0,30770,4021,489,35280,52432
"973",1987,"Scott",150903,15811,2385860,1463,124,0.0366,5.78,91430,20522,17801,2721,84620,8790,12271,3112,7569,54878,3140,3323,46415,-7841,1015,-8856,0,111952,84620,27332,-7841,19491,2345,0,17146,1899,292,19337,36552
"974",1987,"Shelby",13467,13865,186717,816,84,0.0366,5.78,120370,24834,22765,2069,105945,12310,19391,3203,8811,70405,3503,3314,55413,-11148,1209,-12357,0,145204,105945,39259,-11148,28111,1105,0,27006,1759,236,29001,49965
"975",1987,"Sioux",29596,13413,396963,1028,80,0.0366,5.78,372649,39622,32621,7001,324017,61070,119593,5685,13622,309300,5925,11774,106348,-13471,2870,-16341,0,412271,324017,88254,-13471,74783,3115,NA,71667,7623,957,80247,63349
"976",1987,"Story",73312,13739,1007235,1129,82,0.0366,5.78,114339,26753,23294,3459,97718,10865,13311,3390,8517,50799,3243,5489,52903,-13336,845,-14181,0,141092,97718,43374,-13336,30038,3558,0,26480,3264,408,30152,63540
"977",1987,"Tama",17805,14478,257772,913,95,0.0366,5.78,118240,30264,27967,2297,107741,10508,11308,4330,11035,56559,3888,4959,61713,-14272,929,-15201,0,148504,107741,40763,-14272,26491,1493,0,24998,2865,359,28222,61681
"978",1987,"Taylor",7406,11934,88386,489,56,0.0366,5.78,45126,16404,14866,1538,42727,4304,3577,1468,3836,24095,1798,1689,26055,-5087,313,-5400,0,61530,42727,18803,-5087,13716,484,0,13232,855,128,14215,21031
"979",1987,"Union",12854,13011,167242,505,54,0.0366,5.78,39860,10743,9652,1091,40287,4869,7785,1148,2917,24937,1403,1802,20363,-3546,188,-3734,0,50603,40287,10316,-3546,6770,273,0,6497,961,158,7616,14923
"980",1987,"Van Buren",7872,11496,90497,522,NA,0.0366,5.78,37177,10718,9852,866,36663,3985,2991,1356,4043,21505,1283,1729,21276,-3328,342,-3670,0,47895,36663,11232,-3328,7904,295,0,7609,978,129,8716,15672
"981",1987,"Wapello",36237,12924,468324,548,NA,0.0366,5.78,39733,10891,9554,1337,39837,3744,4463,1275,3610,20297,1527,1615,23603,-4307,280,-4587,0,50624,39837,10787,-4307,6480,307,0,6173,853,115,7141,19436
"982",1987,"Warren",35039,13870,485980,688,67,0.0366,5.78,61296,13983,11890,2093,58265,6029,5855,2037,4656,35061,2099,3031,34558,-6004,516,-6520,0,75279,58265,17014,-6004,11010,701,0,10309,1763,254,12326,26235
"983",1987,"Washington",19517,14824,289328,992,NA,0.0366,5.78,127411,24799,22257,2542,108453,21384,11532,3100,8297,89774,3735,4844,55561,-7733,2352,-10085,0,152210,108453,43757,-7733,36024,4203,0,31821,3135,407,35363,37637
"984",1987,"Wayne",7232,12828,92775,401,NA,0.0366,5.78,38083,15088,13890,1198,38081,3032,4622,1207,3313,21696,1531,1281,23095,-4290,82,-4372,0,53171,38081,15090,-4290,10800,184,0,10616,482,71,11169,16387
"985",1987,"Webster",41109,13614,559640,1180,90,0.0366,5.78,123121,30815,27768,3047,112728,12296,5915,4008,10014,40487,3725,5351,71419,-15522,762,-16284,0,153936,112728,41208,-15522,25686,1340,0,24346,3795,473,28614,82634
"986",1987,"Winnebago",12030,15496,186414,1001,81,0.0366,5.78,65642,26159,24709,1450,60184,4650,4966,2686,6213,24318,2373,2149,37147,-8686,618,-9304,0,91801,60184,31617,-8686,22931,1927,0,21004,1047,155,22206,41324
"987",1987,"Winneshiek",20959,13177,276168,701,73,0.0366,5.78,134262,26222,22057,4165,118372,15817,15077,2991,7328,111421,4198,5238,67723,-8632,1001,-9633,0,160484,118372,42112,-8632,33480,512,0,32968,2774,424,36166,22841
"988",1987,"Woodbury",96803,14840,1436551,783,68,0.0366,5.78,136795,37520,33935,3585,128857,13569,30194,3950,10961,83754,3564,5106,61513,-12957,827,-13784,0,174315,128857,45458,-12957,32501,1008,0,31493,2437,331,34261,53041
"989",1987,"Worth",8185,14073,115190,966,77,0.0366,5.78,62925,22597,21188,1409,58704,6700,6483,2330,6074,26608,2300,1888,32929,-7837,542,-8379,0,85522,58704,26818,-7837,18981,594,0,18387,1042,149,19578,36317
"990",1987,"Wright",14431,14913,215216,1224,91,0.0366,5.78,95989,29296,26272,3024,88155,5479,7196,3931,9134,29025,3011,3670,55734,-13592,583,-14175,0,125285,88155,37130,-13592,23538,1539,0,21999,2009,260,24268,66964
"991",1988,"Adair",8509,13311,113262,619,74,0.0408,6.67,85663,17262,13658,3604,74636,9026,8821,3401,7407,42446,2338,2837,40806,-19672,-374,-19298,0,102925,74636,28289,-19672,8617,470,0,8147,1316,183,9646,43217
"992",1988,"Adams",5095,12226,62291,667,71,0.0408,6.67,45395,9238,7820,1418,39934,4179,4314,1749,3911,25058,1586,1759,22436,-10047,-257,-9790,0,54633,39934,14699,-10047,4652,151,0,4501,806,140,5447,20337
"993",1988,"Allamakee",14162,12385,175390,611,82,0.0408,6.67,86901,13516,10813,2703,79345,13337,7819,2206,4590,75962,2635,3926,44832,-8398,-524,-7874,0,100417,79345,21072,-8398,12674,211,0,12463,2308,360,15131,10939
"994",1988,"Appanoose",13960,11474,160173,423,NA,0.0408,6.67,27710,6231,5198,1033,28834,2461,3504,1060,2743,16918,1144,1158,16764,-3830,-330,-3500,0,33941,28834,5107,-3830,1277,NA,0,1247,585,97,1929,10792
"995",1988,"Audubon",7509,13433,100870,1072,NA,0.0408,6.67,99655,16730,13503,3227,81498,11975,15808,2915,6893,54109,2507,3160,38240,-22386,-211,-22175,0,116385,81498,34887,-22386,12501,203,0,12298,1748,262,14308,45546
"996",1988,"Benton",22294,13784,307293,1199,90,0.0408,6.67,145128,29091,24256,4835,141405,17164,26420,5181,13140,84659,4080,5811,69609,-23880,-370,-23510,0,174219,141405,32814,-23880,8934,551,0,8383,3175,454,12012,60469
"997",1988,"Black Hawk",122448,14667,1795972,1330,103,0.0408,6.67,108232,23715,18936,4779,100552,14508,10082,4474,10104,52095,3229,6034,52121,-23416,-69,-23347,0,131947,100552,31395,-23416,7979,809,0,7170,3528,491,11189,56137
"998",1988,"Boone",25175,15430,388443,1340,88,0.0408,6.67,103700,19221,17001,2220,88809,8576,11004,4375,9405,38319,2766,4690,47993,-25631,-100,-25531,0,122921,88809,34112,-25631,8481,1052,0,7429,2887,366,10682,65381
"999",1988,"Bremer",22516,13761,309850,1108,94,0.0408,6.67,82892,17568,14757,2811,80924,10757,7631,3750,8384,48021,2744,3576,44082,-15913,-183,-15730,0,100460,80924,19536,-15913,3623,156,0,3467,1731,282,5480,34871
"1000",1988,"Buchanan",20761,12829,266353,1132,93,0.0408,6.67,119353,25275,22442,2833,109948,14361,12565,4963,12014,65271,3776,5173,57096,-26102,-131,-25971,0,144628,109948,34680,-26102,8578,431,0,8147,3098,448,11693,54082
"1001",1988,"Buena Vista",20166,14584,294097,1470,89,0.0408,6.67,183537,21221,17965,3256,133327,28796,21640,4452,9628,84281,3388,6483,58940,-40237,-79,-40158,0,204758,133327,71431,-40237,31194,1732,NA,29461,4000,499,33960,99256
"1002",1988,"Butler",15967,12920,206291,1239,91,0.0408,6.67,132174,22536,19274,3262,108132,17221,14352,4441,10413,65138,3380,5098,53227,-30721,-102,-30619,0,154710,108132,46578,-30721,15857,944,0,14913,2581,365,17859,67036
"1003",1988,"Calhoun",11633,14598,169817,1414,89,0.0408,6.67,146445,21409,18339,3070,97174,11556,13647,4335,9643,42094,2799,3526,51668,-42086,-88,-41998,0,167854,97174,70680,-42086,28594,993,NA,27600,2002,257,29859,104351
"1004",1988,"Carroll",21729,15447,335644,1320,90,0.0408,6.67,221567,21911,17227,4684,160016,28006,45669,4297,9272,130443,3870,5853,63049,-39931,-402,-39529,0,243478,160016,83462,-39931,43531,1777,NA,41753,3408,480,45641,91124
"1005",1988,"Cass",15328,13951,213840,873,82,0.0408,6.67,103310,18185,15284,2901,86620,9033,16804,3622,7740,49993,2694,3462,43265,-24504,-311,-24193,0,121495,86620,34875,-24504,10371,371,0,10000,1842,251,12093,53317
"1006",1988,"Cedar",17330,14930,258736,1289,108,0.0408,6.67,121252,32156,27961,4195,115450,15184,15831,4832,11199,65471,3439,4618,60347,-22925,-147,-22778,0,153408,115450,37958,-22925,15033,1200,0,13833,2487,368,16688,55781
"1007",1988,"Cerro Gordo",47219,15189,717194,1307,91,0.0408,6.67,117170,25947,23207,2740,86351,9953,4595,4281,9745,33812,3581,5020,49176,-33945,NA,-33935,0,143117,86351,56766,-33945,22821,1725,0,21096,2560,354,24010,83358
"1008",1988,"Cherokee",14276,14935,213218,1243,93,0.0408,6.67,170232,20240,16496,3744,117872,15361,26090,4075,8422,80424,3209,4945,55770,-38087,-309,-37778,0,190472,117872,72600,-38087,34513,1383,NA,33129,2469,333,35931,89808
"1009",1988,"Chickasaw",13538,13326,180404,920,85,0.0408,6.67,94492,21036,17139,3897,90454,11206,13940,4045,9202,57389,3081,3828,45152,-17409,-198,-17211,0,115528,90454,25074,-17409,7665,358,0,7307,2128,301,9736,37103
"1010",1988,"Clarke",8409,12157,102230,482,58,0.0408,6.67,28894,8250,6972,1278,30734,3497,2694,1301,2848,19017,1309,1033,18052,-3951,-258,-3693,0,37144,30734,6410,-3951,2459,57,0,2402,458,73,2933,9877
"1011",1988,"Clay",17194,15782,271363,1348,77,0.0408,6.67,129711,20422,17550,2872,94383,12612,16214,3858,8158,49799,2774,4191,46576,-31357,-150,-31207,0,150133,94383,55750,-31357,24393,1692,0,22701,2362,328,25391,79912
"1012",1988,"Clayton",19369,12602,244093,765,92,0.0408,6.67,156682,27267,19954,7313,142777,25851,13528,4448,9758,131900,4528,6602,78062,-16766,-571,-16195,0,183949,142777,41172,-16766,24406,724,NA,23681,3564,557,27802,24782
"1013",1988,"Clinton",51365,14370,738128,1073,98,0.0408,6.67,123720,39314,34971,4343,124406,13305,21926,5005,12833,77690,3771,5535,62031,-21357,-343,-21014,0,163034,124406,38628,-21357,17271,1158,0,16113,2850,458,19421,46030
"1014",1988,"Crawford",17481,13238,231412,1124,NA,0.0408,6.67,156381,21268,17990,3278,118058,15574,22089,4331,9674,71272,3455,4989,57946,-37604,-368,-37236,0,177649,118058,59591,-37604,21987,910,NA,21076,2743,400,24219,85109
"1015",1988,"Dallas",29176,16343,476833,1041,84,0.0408,6.67,92107,21658,17166,4492,81658,5500,7184,3646,8197,29629,2382,4400,50349,-25803,-118,-25685,0,113765,81658,32107,-25803,6304,578,0,5726,2598,373,8697,62478
"1016",1988,"Davis",8375,11209,93879,544,NA,0.0408,6.67,38136,8866,7282,1584,39121,5985,3913,1561,3569,24656,1404,1289,21400,-5822,-256,-5566,0,47002,39121,7881,-5822,2059,59,0,2000,665,117,2782,13480
"1017",1988,"Decatur",8463,10333,87452,392,52,0.0408,6.67,35993,8043,6801,1242,39962,5621,6992,1195,3138,27260,1346,1739,19931,-3095,-323,-2772,0,44036,39962,4074,-3095,979,51,0,928,1006,138,2072,8733
"1018",1988,"Delaware",17985,13262,238524,1194,100,0.0408,6.67,180610,32400,27776,4624,162226,37300,19636,4667,11054,152275,5323,6532,77714,-20057,-263,-19794,0,213010,162226,50784,-20057,30727,1344,NA,29382,3943,618,33943,28335
"1019",1988,"Des Moines",42801,15410,659570,985,NA,0.0408,6.67,57746,14985,11613,3372,47386,4398,3195,2427,5625,19195,1519,2313,27909,-12201,-98,-12103,0,72731,47386,25345,-12201,13144,1062,0,12082,1101,189,13372,38551
"1020",1988,"Dickinson",14726,16353,240809,1202,88,0.0408,6.67,88014,14634,11491,3143,64983,7894,13903,2404,5239,37333,1813,2638,31092,-20610,-137,-20473,0,102648,64983,37665,-20610,17055,1247,0,15808,1565,214,17587,50681
"1021",1988,"Dubuque",87351,14871,1299010,1054,100,0.0408,6.67,172658,18785,14757,4028,153319,32638,25252,3596,8072,158293,4593,7333,71835,-12661,-630,-12031,0,191443,153319,38124,-12661,25463,573,NA,24889,4457,716,30062,14365
"1022",1988,"Emmet",11674,13607,158847,1387,89,0.0408,6.67,84985,16154,13871,2283,58633,4566,7215,2717,5937,22486,2080,2154,33964,-26352,-82,-26270,0,101139,58633,42506,-26352,16154,618,0,15536,1180,163,16879,62499
"1023",1988,"Fayette",21877,12352,270228,1046,89,0.0408,6.67,155192,28923,24599,4324,136766,20467,15357,5185,12575,96813,4407,7140,71635,-28633,-379,-28254,0,184115,136766,47349,-28633,18716,1117,NA,17598,4120,614,22332,58379
"1024",1988,"Floyd",17400,13963,242960,1119,89,0.0408,6.67,99155,21327,18460,2867,79249,8841,8643,4019,8367,36212,2944,4136,42299,-23900,-83,-23817,0,120482,79249,41233,-23900,17333,1548,0,15785,2531,351,18667,62943
"1025",1988,"Franklin",11532,14309,165007,1389,94,0.0408,6.67,149538,26980,23955,3025,110746,16221,12089,4722,10939,55919,3549,5636,57590,-39642,NA,-39650,0,176518,110746,65772,-39642,26130,1451,NA,24678,2860,388,27926,93619
"1026",1988,"Fremont",8441,14418,121706,839,NA,0.0408,6.67,103615,15654,13101,2553,73239,5844,11243,3345,6742,31538,2279,4155,39631,-28501,-146,-28355,0,119269,73239,46030,-28501,17529,1228,0,16301,2415,309,19025,72077
"1027",1988,"Greene",10311,14388,148352,1244,89,0.0408,6.67,114481,23109,17865,5244,89068,7329,7961,4330,9729,32228,2912,5033,51774,-31693,-126,-31567,0,137590,89068,48522,-31693,16829,1361,0,15468,2622,345,18435,82253
"1028",1988,"Grundy",12274,15096,185283,1403,106,0.0408,6.67,145607,25232,20470,4762,119449,14492,21597,4335,11413,65419,3401,6210,58001,-31680,-138,-31542,0,170839,119449,51390,-31680,19710,2503,NA,17206,3163,426,20795,80188
"1029",1988,"Guthrie",11060,13731,151866,939,80,0.0408,6.67,85725,17490,12855,4635,68453,7713,7646,2605,6741,37534,2409,3094,38245,-22343,-232,-22111,0,103215,68453,34762,-22343,12419,463,0,11956,1571,262,13789,48191
"1030",1988,"Hamilton",16460,14767,243058,1498,94,0.0408,6.67,140786,25202,21702,3500,132526,29323,16421,4504,9839,70681,3804,6431,62204,-27310,NA,-27346,0,165988,132526,33462,-27310,6152,449,0,5703,4420,556,10679,70105
"1031",1988,"Hancock",12864,14898,191642,1375,96,0.0408,6.67,143948,24267,20973,3294,105409,12598,11779,4805,10579,47432,3711,4481,57456,-41130,NA,-41105,0,168215,105409,62806,-41130,21676,963,0,20713,2476,328,23517,96516
"1032",1988,"Hardin",19387,14094,273237,1395,101,0.0408,6.67,131578,27382,23410,3972,120196,19082,17611,4808,10870,67149,3457,5645,58723,-28285,NA,-28240,0,158960,120196,38764,-28285,10479,689,0,9790,3126,455,13371,64429
"1033",1988,"Harrison",15080,12520,188809,882,83,0.0408,6.67,110832,17984,16223,1761,86449,6360,10260,4407,10397,33340,2926,3910,48189,-32334,-262,-32072,0,128816,86449,42367,-32334,10033,458,0,9575,2049,285,11909,77492
"1034",1988,"Henry",19113,14229,271967,932,NA,0.0408,6.67,66197,17183,14132,3051,62977,10141,5186,2560,6383,32560,1904,2896,33907,-12787,-59,-12728,0,83380,62977,20403,-12787,7616,467,0,7149,1629,219,8997,33637
"1035",1988,"Howard",10059,12240,123123,803,83,0.0408,6.67,74652,18957,16210,2747,72091,9915,6678,3258,7900,41406,2653,3603,38084,-14449,-180,-14269,0,93609,72091,21518,-14449,7069,218,0,6851,1841,267,8959,33246
"1036",1988,"Humboldt",10869,14561,158259,1510,97,0.0408,6.67,110109,17229,14844,2385,79265,7162,10587,3704,7918,33877,2268,3082,44544,-30241,-75,-30166,0,127338,79265,48073,-30241,17832,608,0,17224,1810,237,19271,76232
"1037",1988,"Ida",8344,14690,122576,1247,82,0.0408,6.67,115657,15744,13715,2029,80739,8976,17846,3098,6974,51670,2109,3589,38147,-31839,-233,-31606,0,131401,80739,50662,-31839,18823,622,0,18201,1846,241,20288,63987
"1038",1988,"Iowa",14705,14842,218258,1013,86,0.0408,6.67,82690,25147,22598,2549,92855,13155,13828,3676,8558,60102,2818,4686,46134,-8641,-306,-8335,0,107837,92855,14982,-8641,6341,439,0,5902,2881,383,9166,22588
"1039",1988,"Jackson",20584,12593,259219,940,88,0.0408,6.67,98379,20121,17444,2677,101438,16016,20908,2619,6369,86073,3009,4202,48315,-8003,-632,-7371,0,118500,101438,17062,-8003,9059,286,0,8773,2438,424,11635,12306
"1040",1988,"Jasper",34743,15879,551687,1078,86,0.0408,6.67,138854,24135,20119,4016,117594,17382,15032,5008,11172,74036,3544,5359,60097,-28320,-280,-28040,0,162989,117594,45395,-28320,17075,1294,0,15781,3059,417,19257,64818
"1041",1988,"Jefferson",16341,13789,225320,700,NA,0.0408,6.67,49353,12426,10496,1930,47038,5047,4110,2240,5655,25521,1901,2152,25933,-9334,-132,-9202,0,61779,47038,14741,-9334,5407,315,0,5092,1126,157,6375,23832
"1042",1988,"Johnson",92566,15805,1463023,1228,90,0.0408,6.67,98857,21017,16889,4128,100077,20087,11240,3661,8741,68847,3117,4514,48717,-12686,-167,-12519,0,119874,100077,19797,-12686,7111,457,0,6654,2529,348,9531,30010
"1043",1988,"Jones",19142,12198,233486,980,101,0.0408,6.67,114360,25328,22239,3089,119956,19361,24688,4051,9640,89075,3455,4995,53766,-13962,-364,-13598,0,139688,119956,19732,-13962,5770,504,0,5266,2690,421,8377,25285
"1044",1988,"Keokuk",11828,13162,155686,885,NA,0.0408,6.67,83791,22538,20421,2117,83174,12803,7533,3650,9790,53774,3210,3514,42674,-11538,-139,-11399,0,106329,83174,23155,-11538,11617,610,0,11007,2065,281,13353,30017
"1045",1988,"Kossuth",19033,14912,283826,1447,97,0.0408,6.67,256075,43422,36565,6857,175294,18751,18396,8387,17751,75909,6539,7473,97997,-72443,-100,-72343,0,299497,175294,124203,-72443,51760,1914,NA,49845,4334,603,54782,180166
"1046",1988,"Lee",39174,14210,556653,814,NA,0.0408,6.67,64739,13141,10715,2426,62178,9172,8067,2635,6412,41199,2023,2681,31188,-7919,-171,-7748,0,77880,62178,15702,-7919,7783,536,0,7247,1662,271,9180,23540
"1047",1988,"Linn",165979,17590,2919588,1254,90,0.0408,6.67,94172,24263,20187,4076,104261,11207,11941,4808,9999,52825,3511,5960,56835,-15844,-253,-15591,0,118435,104261,14174,-15844,-1670,-298,0,-1372,3172,423,2223,41347
"1048",1988,"Louisa",11636,13485,156909,1108,NA,0.0408,6.67,50740,17246,15593,1653,48668,4431,2991,2570,5996,19285,1780,2496,28404,-10701,-56,-10645,0,67986,48668,19318,-10701,8617,710,0,7907,1389,183,9479,31455
"1049",1988,"Lucas",9294,13916,129335,459,NA,0.0408,6.67,25539,7694,5958,1736,27275,3786,2041,1062,2438,16492,1052,1259,15637,-3861,-243,-3618,0,33233,27275,5958,-3861,2097,73,0,2024,554,85,2663,9047
"1050",1988,"Lyon",11944,12930,154434,1235,83,0.0408,6.67,165207,21867,16461,5406,135610,23158,36384,4143,8145,108446,3349,4572,55859,-24431,-394,-24037,0,187074,135610,51464,-24431,27033,1662,NA,25370,2777,407,28554,56761
"1051",1988,"Madison",12322,13936,171718,718,73,0.0408,6.67,63392,11386,8995,2391,62961,11369,5156,2222,5033,35882,1819,3647,33715,-11460,-266,-11194,0,74778,62961,11817,-11460,357,NA,0,341,2311,282,2934,27510
"1052",1988,"Mahaska",21559,13881,299270,859,NA,0.0408,6.67,120692,19888,16360,3528,108255,18321,18283,3753,8609,80119,3086,5130,51073,-16065,-181,-15884,0,140580,108255,32325,-16065,16260,735,0,15525,3127,409,19061,40573
"1053",1988,"Marion",29886,15209,454532,808,NA,0.0408,6.67,78111,12472,9721,2751,63666,8607,6183,3003,5572,39166,2084,3878,34339,-15244,-169,-15075,0,90583,63666,26917,-15244,11673,567,0,11106,2226,299,13631,38945
"1054",1988,"Marshall",38405,15532,596505,1170,88,0.0408,6.67,97037,27515,22032,5483,90639,9675,11135,4380,9432,42649,3100,5417,47500,-22930,-180,-22750,0,124552,90639,33913,-22930,10983,1053,0,9930,3422,462,13814,54388
"1055",1988,"Mills",13318,17068,227315,862,82,0.0408,6.67,76176,14622,11436,3186,57519,4919,8475,2645,5923,23982,1705,3239,30613,-22125,-120,-22005,0,90798,57519,33279,-22125,11154,670,0,10484,1712,227,12423,52194
"1056",1988,"Mitchell",11110,14692,163231,1057,78,0.0408,6.67,112659,19605,15793,3812,93850,16693,15220,3591,7685,65693,3035,4541,43085,-21179,-115,-21064,0,132264,93850,38414,-21179,17235,617,0,16618,2430,334,19382,46966
"1057",1988,"Monona",10297,13101,134896,912,72,0.0408,6.67,112661,21661,17910,3751,84673,5804,13055,4189,10061,34986,2789,3822,44953,-34018,-223,-33795,0,134322,84673,49649,-34018,15631,538,0,15093,1892,263,17248,77675
"1058",1988,"Monroe",8152,13153,107221,530,NA,0.0408,6.67,29130,5764,4712,1052,32714,4283,4888,1130,2693,21758,1240,1365,17115,-3228,-266,-2962,0,34894,32714,2180,-3228,-1048,NA,0,-1015,723,116,-176,7372
"1059",1988,"Montgomery",12059,14729,177622,789,77,0.0408,6.67,72507,13565,11019,2546,57998,5624,8770,2554,5790,26503,2080,3319,29861,-18724,-171,-18553,0,86072,57998,28074,-18724,9350,311,0,9039,1984,263,11286,46004
"1060",1988,"Muscatine",39740,16243,645488,1169,96,0.0408,6.67,64568,17595,15292,2303,64185,7459,5557,2809,6814,31462,2211,3142,36193,-11931,-131,-11800,0,82163,64185,17978,-11931,6047,534,0,5513,1865,263,7641,33106
"1061",1988,"O'Brien",15556,15734,244759,1555,88,0.0408,6.67,215542,23366,18572,4794,144284,24441,32920,4949,10872,103974,3753,5074,62275,-44826,-219,-44607,0,238908,144284,94624,-44826,49798,2541,NA,47256,2847,394,50497,111568
"1062",1988,"Osceola",7345,13855,101762,1357,81,0.0408,6.67,111231,16143,13707,2436,79656,11216,13667,3111,6482,43638,2462,3176,39542,-27337,-135,-27202,0,127374,79656,47718,-27337,20381,1508,0,18873,1600,228,20701,67593
"1063",1988,"Page",16737,14127,236443,706,68,0.0408,6.67,87015,14132,10657,3475,74473,6799,9206,4681,6334,37189,2117,6060,39276,-16981,-259,-16722,0,101147,74473,26674,-16981,9693,357,0,9336,3965,501,13802,49826
"1064",1988,"Palo Alto",10842,14078,152636,1333,NA,0.0408,6.67,131027,25371,20946,4425,94270,10020,12276,4185,9469,41899,3118,3963,51239,-36524,-70,-36454,0,156398,94270,62128,-36524,25604,1590,0,24014,2080,278,26372,89128
"1065",1988,"Plymouth",23689,13674,323933,1224,83,0.0408,6.67,217125,28254,22500,5754,179461,29613,44531,5728,12367,139507,4608,6475,76139,-34775,-398,-34377,0,245379,179461,65918,-34775,31143,1005,NA,30137,3349,513,33999,77618
"1066",1988,"Pocahontas",9866,14420,142269,1464,87,0.0408,6.67,141763,22460,19744,2716,101833,11843,11827,4579,9506,42845,3048,3377,57653,-39190,NA,-39141,0,164223,101833,62390,-39190,23200,1165,0,22035,1860,266,24161,98918
"1067",1988,"Polk",317114,18851,5977903,1177,86,0.0408,6.67,65437,14535,11907,2628,56043,3131,3074,3390,6789,15943,1944,3889,33826,-18219,-61,-18158,0,79972,56043,23929,-18219,5710,581,0,5129,2297,309,7735,49494
"1068",1988,"Pottawattamie",83331,14458,1204825,909,82,0.0408,6.67,188294,30538,25010,5528,155098,12803,29562,6513,14912,80685,4915,7308,79085,-48344,-431,-47913,0,218832,155098,63734,-48344,15390,1034,NA,14355,4228,557,19140,107609
"1069",1988,"Poweshiek",18919,14993,283653,1027,96,0.0408,6.67,81563,23645,21343,2302,82039,9649,8683,3510,8025,46954,2787,3284,46101,-13433,-272,-13161,0,105208,82039,23169,-13433,9736,324,0,9412,1894,288,11594,34609
"1070",1988,"Ringgold",5422,11996,65041,471,48,0.0408,6.67,40694,10445,8975,1470,40924,5063,4238,1447,3609,26420,1535,1789,23243,-5450,-322,-5128,0,51139,40924,10215,-5450,4765,121,0,4644,903,144,5691,14274
"1071",1988,"Sac",12380,14261,176556,1377,92,0.0408,6.67,181040,20736,16815,3921,128560,19210,28063,4247,9328,87926,3342,6755,57615,-41758,-219,-41539,0,201776,128560,73216,-41758,31458,1590,NA,29867,4050,515,34432,93114
"1072",1988,"Scott",150220,16473,2474578,1566,111,0.0408,6.67,90856,23178,19093,4085,85783,10484,11609,3763,8341,50905,2967,3759,44860,-16706,-128,-16578,0,114034,85783,28251,-16706,11545,1255,0,10290,2221,361,12872,39951
"1073",1988,"Shelby",13416,13945,187084,996,87,0.0408,6.67,141462,21157,18583,2574,109649,14932,19307,4135,10059,67940,3335,3653,54228,-34134,-235,-33899,0,162619,109649,52970,-34134,18836,703,0,18133,2009,281,20423,73522
"1074",1988,"Sioux",29976,13318,399208,1346,84,0.0408,6.67,415770,36422,26418,10004,347789,74671,130267,6879,14792,315975,5655,12354,103171,-46491,-952,-45539,0,452192,347789,104403,-46491,57912,2376,NA,55534,7859,1039,64432,99795
"1075",1988,"Story",73881,14095,1041355,1379,93,0.0408,6.67,114050,24778,19689,5089,99154,12340,12759,4143,9216,45894,2983,6147,51566,-29407,-75,-29332,0,138828,99154,39674,-29407,10267,1050,0,9217,3494,451,13162,68156
"1076",1988,"Tama",17675,14411,254723,1105,98,0.0408,6.67,133541,26591,23356,3235,109012,12210,11151,5211,12352,52398,3661,5280,59147,-35621,-243,-35378,0,160132,109012,51120,-35621,15499,770,0,14729,2954,389,18072,81143
"1077",1988,"Taylor",7240,11097,80340,544,61,0.0408,6.67,44774,13029,10855,2174,44320,5157,4127,1828,4220,23738,1688,2062,25238,-9404,-238,-9166,0,57803,44320,13483,-9404,4079,121,0,3958,1068,168,5194,21036
"1078",1988,"Union",12748,13328,169905,566,71,0.0408,6.67,43437,9108,7450,1658,43133,6522,8253,1362,3190,26639,1338,2046,20422,-7118,-312,-6806,0,52545,43133,9412,-7118,2294,85,0,2209,1122,196,3527,16798
"1079",1988,"Van Buren",7848,11343,89019,598,NA,0.0408,6.67,36166,9339,8012,1327,36993,4793,2936,1573,4064,20367,1232,1782,20613,-5294,-182,-5112,0,45505,36993,8512,-5294,3218,133,0,3085,1010,142,4237,15799
"1080",1988,"Wapello",35591,13569,482928,632,NA,0.0408,6.67,40807,9849,8196,1653,39200,4320,4467,1506,3823,19272,1392,1686,22006,-8086,-131,-7955,0,50656,39200,11456,-8086,3370,149,0,3221,880,128,4229,21535
"1081",1988,"Warren",35172,14681,516346,793,78,0.0408,6.67,64984,12618,9939,2679,59608,6934,5659,2512,5088,32792,2017,3278,34120,-13692,-267,-13425,0,77602,59608,17994,-13692,4302,246,0,4056,1822,289,6167,32192
"1082",1988,"Washington",19635,14367,282088,1151,NA,0.0408,6.67,118848,25244,22069,3175,112989,26985,11506,3766,8767,84433,3441,5260,53264,-13815,NA,-13798,0,144092,112989,31103,-13815,17288,1867,0,15421,3393,462,19276,34415
"1083",1988,"Wayne",7083,12042,85293,454,NA,0.0408,6.67,36044,11624,9845,1779,38571,3650,4382,1474,3709,20760,1417,1438,22501,-5609,-273,-5336,0,47668,38571,9097,-5609,3488,61,0,3427,528,86,4041,15284
"1084",1988,"Webster",40689,14105,573921,1460,97,0.0408,6.67,138881,27922,22939,4983,114101,14678,6176,5001,11128,38090,3492,5600,68026,-36666,NA,-36650,0,166803,114101,52702,-36666,16036,765,0,15271,3896,504,19671,100791
"1085",1988,"Winnebago",12043,16330,196664,1246,89,0.0408,6.67,88797,20379,18254,2125,59960,5256,4290,3326,6804,21253,2330,2354,35600,-28545,NA,-28534,0,109176,59960,49216,-28545,20671,1618,0,19053,1116,182,20351,67544
"1086",1988,"Winneshiek",21046,12872,270900,820,85,0.0408,6.67,130092,22096,16685,5411,120537,19907,15335,3678,7868,108450,3899,5674,64176,-14086,-577,-13509,0,152188,120537,31651,-14086,17565,274,0,17291,3024,501,20816,21642
"1087",1988,"Woodbury",97575,15297,1492611,1002,76,0.0408,6.67,156427,30123,24937,5186,136471,16385,34415,4948,12240,84575,3392,5578,59513,-35088,-419,-34669,0,186550,136471,50079,-35088,14991,429,NA,14561,2720,393,17674,71852
"1088",1988,"Worth",8164,14108,115174,1187,83,0.0408,6.67,78386,18744,16493,2251,59962,8019,6118,2961,6648,25040,2277,1961,31978,-22187,-52,-22135,0,97130,59962,37168,-22187,14981,444,0,14537,1082,166,15785,53346
"1089",1988,"Wright",14318,15316,219293,1529,97,0.0408,6.67,129479,25551,21063,4488,89624,6546,6800,4845,10175,26578,2916,4088,54254,-39840,NA,-39820,0,155030,89624,65406,-39840,25566,1492,0,24074,2205,295,26574,102901
"1090",1989,"Adair",8431,15333,129269,674,77,0.0483,8.11,80679,12295,8676,3619,75605,9078,8876,3547,8500,43171,2228,3065,40311,2737,-183,2920,0,92974,75605,17369,2737,20106,1712,0,18394,1322,198,19914,37508
"1091",1989,"Adams",4987,14161,70622,715,76,0.0483,8.11,44516,7477,5973,1504,41400,4586,4465,1764,4432,25761,1510,1788,22855,1626,-113,1739,0,51993,41400,10593,1626,12219,574,0,11645,780,141,12566,18755
"1092",1989,"Allamakee",14066,13925,195863,697,100,0.0483,8.11,96419,11692,8295,3397,82972,14809,8830,2383,5365,83473,2536,4210,44839,170,-286,456,0,108111,82972,25139,170,25309,636,0,24673,2239,374,27286,12946
"1093",1989,"Appanoose",13818,12436,171841,455,NA,0.0483,8.11,27230,6666,5535,1131,30389,2718,3631,1125,3184,17089,1087,1208,17436,756,NA,746,0,33896,30389,3507,756,4263,140,0,4123,558,102,4783,10141
"1094",1989,"Audubon",7404,15603,115523,1149,91,0.0483,8.11,93420,10674,7235,3439,84909,12096,16597,3147,8019,55281,2401,3307,39342,3063,-279,3342,0,104094,84909,19185,3063,22248,615,0,21633,1756,276,23665,38139
"1095",1989,"Benton",22439,15393,345401,1316,93,0.0483,8.11,149835,22709,17079,5630,145784,18800,26335,5422,15103,85808,3845,5919,70360,5608,-282,5890,0,172544,145784,26760,5608,32368,3041,0,29327,3150,472,32949,64027
"1096",1989,"Black Hawk",123256,15760,1942458,1420,111,0.0483,8.11,98837,17861,12634,5227,103852,14395,10003,4932,12021,53611,3187,6444,52870,3149,-376,3525,0,116698,103852,12846,3149,15995,2417,0,13578,3735,539,17852,45226
"1097",1989,"Boone",25109,16938,425297,1435,98,0.0483,8.11,100876,12841,10210,2631,91777,9074,10992,4618,10674,38775,2609,5024,48786,5182,-140,5322,0,113717,91777,21940,5182,27122,5401,0,21721,2870,388,24979,62101
"1098",1989,"Bremer",22706,15085,342522,1235,104,0.0483,8.11,82131,11883,8448,3435,83525,10950,7506,4023,9794,51372,2678,3831,44743,1990,-221,2211,0,94014,83525,10489,1990,12479,802,0,11677,1848,311,13836,30759
"1099",1989,"Buchanan",20890,14252,297730,1248,83,0.0483,8.11,116279,17392,14103,3289,113204,14376,11988,5368,13857,65200,3669,5740,58206,2806,-463,3269,0,133671,113204,20467,2806,23273,1772,0,21501,3427,518,25446,51079
"1100",1989,"Buena Vista",20053,15951,319856,1576,90,0.0483,8.11,155730,12320,8414,3906,137922,29297,22504,4805,11429,88563,3245,6633,60009,5848,-470,6318,0,168050,137922,30128,5848,35976,3106,NA,32871,3829,509,37209,67167
"1101",1989,"Butler",15826,13900,219978,1309,102,0.0483,8.11,106934,14792,11124,3668,109265,17169,13633,4771,11815,65933,3341,5232,53304,2851,-459,3310,0,121726,109265,12461,2851,15312,1370,0,13942,2631,389,16962,41001
"1102",1989,"Calhoun",11598,15594,180861,1572,96,0.0483,8.11,111325,11639,7969,3670,101056,11617,13200,4784,11608,42476,2740,3510,53597,6688,-219,6907,0,122964,101056,21908,6688,28596,1483,0,27113,1855,255,29223,68849
"1103",1989,"Carroll",21501,16436,353396,1439,93,0.0483,8.11,195810,12912,7353,5559,164915,29173,46944,4609,10861,134240,3680,5847,63801,4316,-756,5072,0,208722,164915,43807,4316,48123,2845,NA,45279,3202,487,48968,61570
"1104",1989,"Cass",15225,15817,240811,939,84,0.0483,8.11,96775,11694,8339,3355,89604,9192,16609,3890,9344,51242,2614,3706,44249,3624,-200,3824,0,108469,89604,18865,3624,22489,1338,0,21151,1904,272,23327,45533
"1105",1989,"Cedar",17381,16519,287113,1418,107,0.0483,8.11,127479,18641,14184,4457,119439,15747,14803,5208,13074,65183,3487,5187,61933,3753,-486,4239,0,146120,119439,26681,3753,30434,3682,0,26752,2725,412,29889,62296
"1106",1989,"Cerro Gordo",46840,15920,745688,1372,100,0.0483,8.11,83764,15281,12199,3082,89121,9761,4632,4713,11534,33482,3481,5509,49491,3405,-257,3662,0,99045,89121,9924,3405,13329,1492,0,11837,2779,394,15010,50282
"1107",1989,"Cherokee",14139,15639,221121,1329,93,0.0483,8.11,137606,12007,7432,4575,118955,15406,24358,4341,9825,79972,3128,5012,56885,4709,-442,5151,0,149613,118955,30658,4709,35367,2289,0,33078,2504,356,35938,57634
"1108",1989,"Chickasaw",13417,14546,195170,1008,83,0.0483,8.11,93108,14358,10209,4149,94051,11722,14567,4307,10545,60500,2986,4179,45745,2244,-315,2559,0,107466,94051,13415,2244,15659,1114,0,14545,2129,318,16992,32608
"1109",1989,"Clarke",8327,13600,113249,538,NA,0.0483,8.11,27690,8319,6917,1402,31371,3575,2917,1213,3005,19005,1212,1070,18379,771,-67,838,0,36009,31371,4638,771,5409,210,0,5199,479,76,5754,8685
"1110",1989,"Clay",17452,16598,289662,1454,86,0.0483,8.11,108424,12163,9073,3090,97260,12738,15351,4109,9469,50741,2687,4935,47971,5584,-169,5753,0,120587,97260,23327,5584,28911,3331,0,25580,2683,379,28642,57683
"1111",1989,"Clayton",19218,14446,277616,884,87,0.0483,8.11,170671,23352,15167,8185,147451,27273,14172,4713,11226,140144,4379,7177,78511,NA,-701,728,0,194023,147451,46572,NA,46599,2153,NA,44447,3735,611,48793,30527
"1112",1989,"Clinton",51062,15665,799866,1162,100,0.0483,8.11,140456,21183,16343,4840,128970,13935,23551,5170,14627,79741,3658,5787,62242,3838,-376,4214,0,161639,128970,32669,3838,36507,3666,0,32841,2918,494,36253,60715
"1113",1989,"Crawford",17060,14115,240800,1194,87,0.0483,8.11,129956,12429,8823,3606,121716,15782,21667,4661,11721,71927,3280,5099,59506,4326,-369,4695,0,142385,121716,20669,4326,24995,1509,0,23486,2691,422,26599,58029
"1114",1989,"Dallas",29314,17831,522687,1161,86,0.0483,8.11,91724,14299,9146,5153,83669,5563,6916,3906,9576,30034,2280,4919,50509,4903,-106,5009,0,106023,83669,22354,4903,27257,3603,0,23654,2877,431,26962,61690
"1115",1989,"Davis",8301,12334,102387,579,NA,0.0483,8.11,35360,8428,6712,1716,40529,6267,3983,1515,3888,25960,1321,1464,22091,927,69,858,0,43788,40529,3259,927,4186,200,0,3986,754,137,4877,9400
"1116",1989,"Decatur",8490,11974,101663,439,63,0.0483,8.11,38843,8559,6948,1611,40971,6170,7642,1144,3220,29188,1253,1876,19666,809,-88,897,0,47402,40971,6431,809,7240,555,0,6685,1074,152,7911,9655
"1117",1989,"Delaware",18054,15077,272208,1314,105,0.0483,8.11,194850,19289,14424,4865,167412,38414,20964,4944,12459,160382,5096,6729,78806,683,-1194,1877,0,214139,167412,46727,683,47410,3231,NA,44180,3862,647,48689,34468
"1118",1989,"Des Moines",42606,16444,700611,1064,NA,0.0483,8.11,47632,10023,6589,3434,48751,4584,2963,2588,6419,19453,1463,2407,28327,2340,-94,2434,0,57655,48751,8904,2340,11244,1413,0,9831,1126,199,11156,28179
"1119",1989,"Dickinson",14846,17883,265495,1319,84,0.0483,8.11,76161,8893,5779,3114,67744,8241,14371,2662,6281,38484,1758,2915,31516,3236,NA,3281,0,85054,67744,17310,3236,20546,2336,0,18210,1559,223,19992,37677
"1120",1989,"Dubuque",86644,16099,1394895,1180,97,0.0483,8.11,191184,17642,12881,4761,160968,35319,27012,3822,9431,173804,4370,7428,73586,-209,-856,647,0,208826,160968,47858,-209,47649,1668,NA,45982,4219,728,50929,17380
"1121",1989,"Emmet",11533,14828,171017,1499,97,0.0483,8.11,67464,9197,6925,2272,60193,4539,7462,2894,6864,23096,2056,2336,34042,3980,-122,4102,0,76661,60193,16468,3980,20448,1224,0,19224,1251,178,20653,44368
"1122",1989,"Fayette",21845,14026,306392,1149,95,0.0483,8.11,159229,19707,14968,4739,141650,21454,15978,5569,14794,103813,4277,7650,71928,3119,-431,3550,0,178936,141650,37286,3119,40405,3493,NA,36913,4326,672,41911,55416
"1123",1989,"Floyd",17312,14714,254732,1169,98,0.0483,8.11,75857,13518,10443,3075,82297,8920,8874,4361,9790,37502,2871,4405,43076,2698,-281,2979,0,89375,82297,7078,2698,9776,1303,0,8473,2669,385,11527,38355
"1124",1989,"Franklin",11398,15459,176198,1473,106,0.0483,8.11,122641,14621,11248,3373,113919,16624,12276,5110,12535,55850,3489,5767,58118,5291,-255,5546,0,137262,113919,23343,5291,28634,2402,0,26232,2860,404,29496,66791
"1125",1989,"Fremont",8252,14877,122762,909,NA,0.0483,8.11,76720,8940,5841,3099,75969,5776,11309,3456,8188,31321,2165,4475,40600,3683,-78,3761,0,85660,75969,9691,3683,13374,1499,0,11875,2471,330,14676,45399
"1126",1989,"Greene",10167,16188,164579,1362,94,0.0483,8.11,98876,17539,10388,7151,92572,7251,8100,4736,11482,32001,2782,5242,52979,6063,-157,6220,0,116415,92572,23843,6063,29906,3741,0,26165,2633,368,29166,66875
"1127",1989,"Grundy",12115,16202,196290,1493,112,0.0483,8.11,118901,15722,9319,6403,121469,14987,21122,4593,13185,64848,3160,6617,57805,4383,-324,4707,0,134623,121469,13154,4383,17537,3282,0,14255,3211,454,17920,54053
"1128",1989,"Guthrie",10920,15725,171718,1017,86,0.0483,8.11,80711,12155,7622,4533,73265,9053,7894,2913,8199,39735,2317,3598,39291,3226,-219,3445,0,92866,73265,19601,3226,22827,1255,0,21572,1917,319,23808,40976
"1129",1989,"Hamilton",16303,17670,288079,1614,104,0.0483,8.11,152794,16289,12684,3605,135713,29486,15557,4973,11540,73364,3698,6968,63491,6134,-473,6607,0,169083,135713,33370,6134,39504,4331,0,35173,4639,605,40417,79430
"1130",1989,"Hancock",12832,15230,195432,1464,109,0.0483,8.11,109861,13858,9843,4015,108064,13105,11580,5163,11963,48311,3649,4502,58102,4676,-342,5018,0,123719,108064,15655,4676,20331,1374,0,18957,2342,335,21634,61550
"1131",1989,"Hardin",19214,15448,296816,1484,106,0.0483,8.11,127620,16540,12153,4387,125015,21258,17369,5074,12638,70506,3419,5938,59319,4534,-388,4922,0,144160,125015,19145,4534,23679,2333,0,21346,3099,475,24920,57114
"1132",1989,"Harrison",14832,13477,199894,964,86,0.0483,8.11,83630,10704,8561,2143,90508,6325,10437,4807,12355,33726,2865,4130,49589,4133,-149,4282,0,94334,90508,3826,4133,7959,559,0,7400,2018,294,9712,49904
"1133",1989,"Henry",19054,15281,291172,1027,NA,0.0483,8.11,57355,12605,9565,3040,64105,10175,5031,2799,7336,32918,1806,3025,33933,2133,-148,2281,0,69960,64105,5855,2133,7988,777,0,7211,1572,224,9007,24437
"1134",1989,"Howard",9913,14334,142090,889,77,0.0483,8.11,79142,13240,10026,3214,74789,10378,6789,3610,9243,43659,2580,3717,38472,2730,-226,2956,0,92382,74789,17593,2730,20323,966,0,19357,1826,280,21463,35483
"1135",1989,"Humboldt",10761,16807,180858,1595,109,0.0483,8.11,96490,9834,6895,2939,82181,7364,9956,4074,9491,33772,2234,3041,46021,5412,-225,5637,0,106324,82181,24143,5412,29555,1618,0,27937,1679,233,29849,62718
"1136",1989,"Ida",8392,15531,130334,1327,92,0.0483,8.11,93260,8438,6173,2265,82520,9056,16943,3303,8140,50896,2045,3658,39375,3290,-241,3531,0,101698,82520,19178,3290,22468,1240,0,21228,1772,248,23248,42364
"1137",1989,"Iowa",14653,16638,243791,1103,87,0.0483,8.11,96688,17000,13986,3014,94635,13451,13951,3875,9641,60642,2720,5011,45986,1953,-353,2306,0,113688,94635,19053,1953,21006,2165,0,18841,2960,412,22213,36046
"1138",1989,"Jackson",20188,13889,280385,1012,86,0.0483,8.11,109483,14905,11495,3410,107381,17442,22421,2744,7322,90667,2922,4334,50196,393,-345,738,0,124388,107381,17007,393,17400,863,0,16537,2436,439,19412,18816
"1139",1989,"Jasper",34755,16931,588449,1146,94,0.0483,8.11,132107,16694,12216,4478,122194,17982,15238,5382,13023,75963,3388,5572,61609,4206,-499,4705,0,148801,122194,26607,4206,30813,3694,0,27119,3084,445,30648,56144
"1140",1989,"Jefferson",16378,14887,243815,789,NA,0.0483,8.11,49171,10333,8266,2067,49021,5434,4227,2377,6229,26400,1773,2276,26705,2142,-136,2278,0,59504,49021,10483,2142,12625,1090,0,11535,1159,169,12863,22771
"1141",1989,"Johnson",94369,17385,1640558,1329,94,0.0483,8.11,104789,19608,14805,4803,102133,20522,11389,3878,9897,70191,2997,4575,48875,2522,-305,2827,0,124397,102133,22264,2522,24786,2398,0,22388,2462,363,25213,34598
"1142",1989,"Jones",19388,13779,267138,1088,101,0.0483,8.11,126225,19249,15549,3700,123593,20197,24428,4314,11179,92908,3373,5194,54908,1602,-561,2163,0,145474,123593,21881,1602,23483,3194,0,20289,2716,445,23450,33317
"1143",1989,"Keokuk",11658,15218,177413,1005,NA,0.0483,8.11,88584,19276,17141,2135,84468,13662,7386,3732,10585,53643,2938,3614,42551,2451,-323,2774,0,107860,84468,23392,2451,25843,2259,0,23584,1973,289,25846,34941
"1144",1989,"Kossuth",18839,16042,302215,1563,106,0.0483,8.11,200510,22846,15564,7282,182286,18186,18233,9421,20880,76155,6450,8034,101082,10136,-503,10639,0,223356,182286,41070,10136,51206,3069,NA,48138,4433,648,53219,124355
"1145",1989,"Lee",38882,15230,592172,865,NA,0.0483,8.11,59244,11629,8930,2699,65877,9721,8386,2857,7291,42733,1996,3104,32522,1628,-254,1882,0,70873,65877,4996,1628,6624,724,0,5900,1869,306,8075,16511
"1146",1989,"Linn",167701,19099,3202848,1375,92,0.0483,8.11,105994,21290,16779,4511,106173,11630,11439,4981,11491,53687,3347,6178,57107,3797,-265,4062,0,127284,106173,21111,3797,24908,3051,0,21857,3073,439,25369,52307
"1147",1989,"Louisa",11567,14916,172529,1246,NA,0.0483,8.11,45055,13092,11068,2024,49291,4458,2937,2747,6783,18667,1694,2576,28096,2342,-149,2491,0,58147,49291,8856,2342,11198,1427,0,9771,1357,190,11318,26388
"1148",1989,"Lucas",9177,14848,136257,497,NA,0.0483,8.11,23583,7167,5343,1824,28165,3856,2200,1003,2625,17012,994,1335,16152,692,NA,671,0,30750,28165,2585,692,3277,170,0,3107,565,94,3766,6571
"1149",1989,"Lyon",11901,14777,175858,1322,87,0.0483,8.11,164895,13410,7373,6037,143309,25281,38681,4458,9478,116163,3223,5163,57025,4835,-472,5307,0,178305,143309,34996,4835,39831,4171,NA,35661,3044,465,39170,48732
"1150",1989,"Madison",12405,15435,191468,834,81,0.0483,8.11,66760,10224,7119,3105,66485,11998,5663,2399,6011,38130,1768,3866,34780,2267,NA,2312,0,76984,66485,10499,2267,12766,858,0,11908,2304,302,14514,28630
"1151",1989,"Mahaska",21410,14893,318859,979,NA,0.0483,8.11,120968,16824,13034,3790,111037,19168,17946,3925,9734,81019,2960,5340,51964,3020,-526,3546,0,137792,111037,26755,3020,29775,2329,0,27446,3072,430,30948,39949
"1152",1989,"Marion",30033,16067,482533,881,NA,0.0483,8.11,68571,8576,5779,2797,65204,8716,6658,3129,6289,39348,1924,4025,34463,2113,-266,2379,0,77147,65204,11943,2113,14056,1043,0,13013,2076,305,15394,29223
"1153",1989,"Marshall",38273,17407,666237,1254,98,0.0483,8.11,99390,19380,12414,6966,94149,9936,10525,4695,11255,43110,3022,5737,48979,4053,-254,4307,0,118770,94149,24621,4053,28674,4145,0,24529,3495,498,28522,56280
"1154",1989,"Mills",13240,17774,235324,922,87,0.0483,8.11,58047,8524,5399,3125,60897,4859,8467,2894,7129,23521,1685,3735,32128,2904,-97,3001,0,66571,60897,5674,2904,8578,817,0,7761,2071,282,10114,34526
"1155",1989,"Mitchell",11006,16766,184531,1114,88,0.0483,8.11,110135,13435,9249,4186,97286,17112,15791,3902,8776,68268,2959,4862,43884,3034,-264,3298,0,123570,97286,26284,3034,29318,1585,0,27733,2519,364,30616,41867
"1156",1989,"Monona",10157,14431,146576,965,81,0.0483,8.11,90106,12669,8741,3928,89373,6292,13298,4480,11864,36833,2683,4159,46597,4518,-148,4666,0,102775,89373,13402,4518,17920,988,0,16932,1974,287,19193,53273
"1157",1989,"Monroe",8092,14433,116793,599,NA,0.0483,8.11,30261,5661,4565,1096,33479,4355,5043,1059,2749,22393,1131,1425,17717,548,-50,598,0,35922,33479,2443,548,2991,79,0,2912,765,131,3808,7868
"1158",1989,"Montgomery",12110,16305,197457,838,81,0.0483,8.11,63312,9182,5801,3381,59536,5557,8476,2599,6558,26382,1997,3873,30476,2847,-128,2975,0,72494,59536,12958,2847,15805,901,0,14904,2351,316,17571,36930
"1159",1989,"Muscatine",39760,17275,686847,1290,92,0.0483,8.11,66897,11907,9545,2362,65945,8194,5413,3000,7585,32198,2128,3159,36466,2446,-200,2646,0,78804,65945,12859,2446,15305,2104,0,13201,1823,269,15293,34699
"1160",1989,"O'Brien",15521,16208,251563,1663,93,0.0483,8.11,172329,13268,7822,5446,143274,24768,29119,5215,12534,100021,3562,5261,62815,6066,-578,6644,0,185597,143274,42323,6066,48389,3794,NA,44596,2847,419,47862,72308
"1161",1989,"Osceola",7259,14780,107291,1452,78,0.0483,8.11,93015,8956,5693,3263,84493,11671,13864,3480,7857,46605,2512,3518,41591,4407,-205,4612,0,101971,84493,17478,4407,21885,2774,0,19111,1762,260,21133,46410
"1162",1989,"Page",16842,15843,266827,749,73,0.0483,8.11,81423,11257,7207,4050,76019,6926,8904,4497,7419,36902,2045,6345,39883,3073,-198,3271,0,92680,76019,16661,3073,19734,1105,0,18629,4079,548,23256,44521
"1163",1989,"Palo Alto",10763,14909,160464,1446,99,0.0483,8.11,103987,14707,9950,4757,97103,10128,12414,4455,10894,43128,3072,4003,52137,5596,-273,5869,0,118694,97103,21591,5596,27187,2669,0,24518,2026,284,26828,60859
"1164",1989,"Plymouth",23448,15904,372919,1290,81,0.0483,8.11,212929,20910,14640,6270,187342,30879,45857,6203,14599,144653,4591,6979,78234,5641,-831,6472,0,233839,187342,46497,5641,52138,2577,NA,49562,3511,567,53640,68276
"1165",1989,"Pocahontas",9713,15967,155091,1577,92,0.0483,8.11,114879,11876,9029,2847,104663,11409,11333,5070,11381,42520,3014,3780,58676,6853,-255,7108,0,126755,104663,22092,6853,28945,2211,0,26734,1922,286,28942,72359
"1166",1989,"Polk",322465,20076,6473812,1265,90,0.0483,8.11,62822,9864,6549,3315,57744,3342,3149,3553,7566,15858,1849,3987,34298,3539,NA,3558,0,72686,57744,14942,3539,18481,2821,0,15660,2343,328,18331,46964
"1167",1989,"Pottawattamie",82776,15011,1242546,984,85,0.0483,8.11,154471,18847,12960,5887,160426,13072,29641,7046,17353,82421,4737,7880,80697,5575,-319,5894,0,173318,160426,12892,5575,18467,1961,0,16506,4205,597,21308,72050
"1168",1989,"Poweshiek",19054,16441,313259,1101,89,0.0483,8.11,86468,16009,13374,2635,84135,10207,8760,3673,9123,47087,2711,3214,46447,3267,-209,3476,0,102477,84135,18342,3267,21609,1193,0,20416,1767,292,22475,39381
"1169",1989,"Ringgold",5435,13704,74479,517,69,0.0483,8.11,41169,10458,8994,1464,41354,5240,4162,1459,4044,26239,1487,1751,23211,1371,-109,1480,0,51627,41354,10273,1371,11644,424,0,11220,833,145,12198,14930
"1170",1989,"Sac",12350,15158,187203,1501,91,0.0483,8.11,146920,11209,7179,4030,131732,19997,27340,4683,11231,88955,3270,6790,58421,5377,-457,5834,0,158129,131732,26397,5377,31774,2411,0,29363,3827,524,33714,57965
"1171",1989,"Scott",150044,17608,2641911,1739,106,0.0483,8.11,97645,14212,9171,5041,87655,10684,10869,3965,9702,50784,2858,4139,45438,2391,-335,2726,0,111857,87655,24202,2391,26593,4425,0,22168,2407,395,24970,46861
"1172",1989,"Shelby",13279,15327,203521,1052,87,0.0483,8.11,126026,11763,9029,2734,113455,15446,18622,4593,12039,68927,3237,3930,55588,3948,-447,4395,0,137789,113455,24334,3948,28282,1692,0,26590,2136,311,29037,57099
"1173",1989,"Sioux",29876,14874,444386,1431,87,0.0483,8.11,413805,23920,12072,11848,360613,78082,134576,7283,17059,332373,5524,12802,105287,6212,-850,7062,0,437725,360613,77112,6212,83324,5644,NA,77681,7645,1103,86429,81432
"1174",1989,"Story",73711,15462,1139732,1488,98,0.0483,8.11,110060,17744,11563,6181,101154,12006,12023,4405,10555,44346,2796,6709,52660,5444,-222,5666,0,127804,101154,26650,5444,32094,4809,0,27285,3508,475,31268,65714
"1175",1989,"Tama",17487,15383,268996,1186,102,0.0483,8.11,108464,17646,13799,3847,111509,12146,10877,5469,14552,51958,3514,5533,59418,4366,-273,4639,0,126110,111509,14601,4366,18967,1408,0,17559,2861,396,20816,56506
"1176",1989,"Taylor",7188,12210,87769,594,NA,0.0483,8.11,43391,11006,8428,2578,46413,5276,4607,1974,4900,24582,1615,2422,25619,1656,-148,1804,0,54397,46413,7984,1656,9640,406,0,9234,1216,197,10647,18809
"1177",1989,"Union",12634,14501,183206,619,69,0.0483,8.11,43214,7222,5135,2087,45342,7303,7973,1412,3686,27720,1300,2252,21416,1411,138,1273,0,50436,45342,5094,1411,6505,376,0,6129,1214,210,7553,15494
"1178",1989,"Van Buren",7669,12757,97835,647,NA,0.0483,8.11,33402,8949,7248,1701,37669,4922,2875,1597,4347,20623,1207,1794,20927,1224,-85,1309,0,42351,37669,4682,1224,5906,440,0,5466,979,147,6592,12779
"1179",1989,"Wapello",35674,14719,525084,708,NA,0.0483,8.11,38066,7785,6029,1756,39056,4269,4402,1555,4295,19391,1294,1745,21496,1711,NA,1745,0,45851,39056,6795,1711,8506,597,0,7909,855,132,8896,18675
"1180",1989,"Warren",35655,15560,554796,882,86,0.0483,8.11,58807,9372,6436,2936,61597,6829,5406,2691,5875,32649,1976,3548,35272,1847,-187,2034,0,68179,61597,6582,1847,8429,733,0,7696,1769,300,9765,26158
"1181",1989,"Washington",19593,16119,315814,1291,NA,0.0483,8.11,123316,20804,17440,3364,116707,28859,11714,3983,9831,87763,3232,5568,53520,2722,-606,3328,0,144120,116707,27413,2722,30135,5093,0,25042,3441,494,28977,35553
"1182",1989,"Wayne",7057,13416,94675,493,NA,0.0483,8.11,33833,11548,9347,2201,39591,3749,3981,1566,4370,20543,1338,1620,22967,1136,-68,1204,0,45381,39591,5790,1136,6926,209,0,6717,543,95,7355,13290
"1183",1989,"Webster",40505,15526,628897,1580,104,0.0483,8.11,134583,18390,11862,6528,116866,14968,6476,5408,13033,39267,3338,5727,67916,8377,-197,8574,0,152973,116866,36107,8377,44484,3284,0,41200,3755,510,45465,95316
"1184",1989,"Winnebago",12129,16394,198846,1347,102,0.0483,8.11,65024,10724,8129,2595,60905,5087,3749,3576,7872,20455,2328,2533,35760,3245,-170,3415,0,75748,60905,14843,3245,18088,2227,0,15861,1118,192,17171,44569
"1185",1989,"Winneshiek",21032,14670,308531,908,80,0.0483,8.11,141498,18650,12716,5934,123356,21241,15789,3930,8949,116054,3693,6015,63739,799,-356,1155,0,160148,123356,36792,799,37591,995,0,36596,3087,531,40214,25444
"1186",1989,"Woodbury",97744,16205,1583935,1060,82,0.0483,8.11,147425,20732,14502,6230,143154,16879,36846,5369,14392,87505,3292,6038,60338,4240,-331,4571,0,168157,143154,25003,4240,29243,1310,0,27933,2836,433,31202,59920
"1187",1989,"Worth",8094,15141,122554,1279,89,0.0483,8.11,66925,10857,7944,2913,61741,8196,5778,3249,7687,25646,2293,1999,32539,3025,-165,3190,0,77782,61741,16041,3025,19066,905,0,18161,1055,170,19386,41279
"1188",1989,"Wright",14348,17005,243993,1646,110,0.0483,8.11,105885,15407,9931,5476,92811,6680,6348,5187,11940,26164,2877,4445,55334,6976,-171,7147,0,121292,92811,28481,6976,35457,3130,0,32327,2265,313,34905,79721
"1189",1990,"Adair",8397,16023,134547,734,83,0.0539,7.5,83291,9381,6231,3150,77695,8885,10200,3508,8811,50350,2624,3204,40463,1231,-332,1563,0,92672,77695,14977,1231,16208,1348,0,14860,1469,216,16545,32941
"1190",1990,"Adams",4845,14929,72330,769,76,0.0539,7.5,50100,5998,4599,1399,43538,4837,5274,1693,4546,30404,1777,1757,23654,663,-241,904,0,56098,43538,12560,663,13223,563,0,12660,829,142,13631,19696
"1191",1990,"Allamakee",13836,14964,207036,770,95,0.0539,7.5,107226,9728,6104,3624,87375,15764,10491,2429,5650,94025,3016,4450,45575,672,-455,1127,0,116954,87375,29579,672,30251,719,0,29532,2397,394,32323,13201
"1192",1990,"Appanoose",13744,13269,182371,502,NA,0.0539,7.5,30748,4545,3447,1098,28632,2577,3527,1002,2957,19277,1133,1087,16349,274,-357,631,0,35293,28632,6661,274,6935,202,0,6733,584,110,7427,11471
"1193",1990,"Audubon",7335,15794,115848,1217,89,0.0539,7.5,101391,9878,6697,3181,91416,11888,20529,3205,8411,65691,2840,3441,41102,1415,-87,1502,0,111269,91416,19853,1415,21268,1675,0,19593,1948,296,21837,35700
"1194",1990,"Benton",22425,15946,357589,1415,97,0.0539,7.5,169041,15382,9734,5648,153859,19804,30255,5377,15679,99226,4476,5998,72270,2255,-257,2512,0,184423,153859,30564,2255,32819,2942,NA,29876,3454,501,33831,69815
"1195",1990,"Black Hawk",124155,16417,2038289,1515,112,0.0539,7.5,119471,14051,9094,4957,109188,13912,12031,5108,12843,63296,3883,6917,54494,2166,107,2059,0,133522,109188,24334,2166,26500,3739,0,22761,4349,599,27709,56175
"1196",1990,"Boone",25200,17250,434698,1553,102,0.0539,7.5,100723,10036,7343,2693,96662,9289,13003,4615,10958,45377,3040,5372,50385,1818,NA,1853,0,110759,96662,14097,1818,15915,3174,0,12741,3157,420,16318,55346
"1197",1990,"Bremer",22854,16164,369416,1324,112,0.0539,7.5,97912,9796,6203,3593,86773,10838,8164,4075,10307,58512,3229,4017,46143,1631,-103,1734,0,107708,86773,20935,1631,22566,1354,0,21212,2159,349,23720,39400
"1198",1990,"Buchanan",20842,15143,315619,1336,101,0.0539,7.5,133695,12653,9342,3311,118746,14012,13758,5475,14428,74490,4404,6388,60281,2540,83,2457,0,146348,118746,27602,2540,30142,2181,0,27961,4130,607,32698,59205
"1199",1990,"Buena Vista",19992,16197,323816,1649,94,0.0539,7.5,168851,11876,7858,4018,146712,28986,27911,4891,12192,106236,3842,6817,62073,2502,156,2346,0,180727,146712,34015,2502,36517,3066,NA,33450,4062,530,38042,62615
"1200",1990,"Butler",15713,15455,242850,1385,100,0.0539,7.5,129630,13675,10090,3585,113031,16670,15754,4839,12127,77228,4077,5313,54251,2248,129,2119,0,143305,113031,30274,2248,32522,2742,0,29780,2961,428,33169,52402
"1201",1990,"Calhoun",11501,15331,176320,1682,94,0.0539,7.5,112440,11558,7793,3765,107502,11370,15450,4960,12521,50219,3313,3459,56429,2293,NA,2257,0,123998,107502,16496,2293,18789,912,0,17877,1899,262,20038,62221
"1202",1990,"Carroll",21415,16583,355130,1523,101,0.0539,7.5,217167,12633,6974,5659,189168,31431,60380,4941,12130,160161,4582,6167,69537,2120,-67,2187,0,229800,189168,40632,2120,42752,4508,NA,38243,3318,505,42066,57006
"1203",1990,"Cass",15110,16019,242047,1006,97,0.0539,7.5,102944,10116,6766,3350,94900,9097,18741,3944,10103,60155,3133,3912,45970,1559,-272,1831,0,113060,94900,18160,1559,19719,1210,0,18509,2172,302,20983,42789
"1204",1990,"Cedar",17447,17236,300708,1504,110,0.0539,7.5,140645,13245,9130,4115,126644,15848,17103,5298,13756,76686,4355,5730,64554,2593,94,2499,0,153890,126644,27246,2593,29839,3426,0,26413,3262,470,30145,63959
"1205",1990,"Cerro Gordo",46773,17097,799675,1437,104,0.0539,7.5,107136,14538,11530,3008,93104,9330,5886,4876,12273,39304,4182,5938,50619,2539,118,2421,0,121674,93104,28570,2539,31109,3236,0,27873,3305,451,31629,67832
"1206",1990,"Cherokee",14107,16683,235354,1402,92,0.0539,7.5,148411,12044,7276,4768,125488,15192,27139,4408,10407,91940,3802,5066,59474,2077,-112,2189,0,160455,125488,34967,2077,37044,2412,0,34632,2807,389,37828,56471
"1207",1990,"Chickasaw",13288,15492,205858,1082,86,0.0539,7.5,110950,11911,8073,3838,99760,11885,17485,4335,10916,71227,3573,4471,47095,1658,-69,1727,0,122861,99760,23101,1658,24759,1680,0,23079,2355,343,25777,39723
"1208",1990,"Clarke",8301,14239,118197,591,59,0.0539,7.5,32174,6206,4857,1349,30611,3344,3327,1010,2710,21807,1302,1017,17901,320,-263,583,0,38380,30611,7769,320,8089,326,0,7763,549,81,8393,10367
"1209",1990,"Clay",17654,16858,297603,1521,91,0.0539,7.5,117321,11785,8894,2891,102730,12520,17075,4139,9913,59310,3216,5695,50172,2122,NA,2158,0,129106,102730,26376,2122,28498,3381,0,25117,3307,442,28866,58011
"1210",1990,"Clayton",19064,15437,294290,976,99,0.0539,7.5,189794,17289,9370,7919,153805,27857,16394,4723,11664,157254,5232,7688,80247,1848,-328,2176,0,207083,153805,53278,1848,55126,2483,NA,52642,4300,679,57621,32540
"1211",1990,"Clinton",51091,16345,835087,1246,102,0.0539,7.5,156344,15726,11044,4682,137129,14143,29040,5070,15074,93383,4384,5948,63470,2507,-206,2713,0,172070,137129,34941,2507,37448,3532,NA,33915,3287,544,37746,62961
"1212",1990,"Crawford",16737,15242,255098,1260,88,0.0539,7.5,141774,12274,8814,3460,129093,15557,25017,4733,12708,84217,3849,5171,62058,2155,-228,2383,0,154048,129093,24955,2155,27110,1494,0,25616,2913,457,28986,57557
"1213",1990,"Dallas",29904,18264,546175,1253,86,0.0539,7.5,90725,12017,6922,5095,86904,5474,7692,3952,10079,34389,2697,5518,51492,1915,-78,1993,0,102742,86904,15838,1915,17753,2117,0,15636,3472,508,19616,56336
"1214",1990,"Davis",8321,13830,115083,627,NA,0.0539,7.5,43914,6894,5262,1632,42412,6362,4493,1400,3843,30618,1535,1625,23154,393,-298,691,0,50808,42412,8396,393,8789,432,0,8357,923,161,9441,13296
"1215",1990,"Decatur",8303,12430,103210,485,75,0.0539,7.5,44269,6550,4782,1768,42880,6511,9142,1042,2995,35226,1440,2035,19715,209,-324,533,0,50819,42880,7939,209,8148,577,0,7571,1259,170,9000,9043
"1216",1990,"Delaware",18046,15949,287819,1432,105,0.0539,7.5,223196,13396,8941,4455,187326,40971,27852,5246,13455,186587,6389,7357,86056,2681,239,2442,0,236592,187326,49266,2681,51947,3450,NA,48496,4167,685,53348,36609
"1217",1990,"Des Moines",42668,17421,743322,1137,NA,0.0539,7.5,58368,7568,4539,3029,50508,4634,3246,2608,6623,22749,1741,2442,29214,1071,-53,1124,0,65936,50508,15428,1071,16499,2019,0,14480,1263,213,15956,35619
"1218",1990,"Dickinson",14935,18641,278406,1392,84,0.0539,7.5,80335,8443,5784,2659,72239,8343,16640,2767,6754,44749,2105,3169,32461,1144,-132,1276,0,88778,72239,16539,1144,17683,1956,0,15727,1717,237,17681,35586
"1219",1990,"Dubuque",86462,16870,1458623,1298,123,0.0539,7.5,220239,11311,6454,4857,187202,40381,34667,4179,10801,201152,5596,8179,83399,1476,-350,1826,0,231550,187202,44348,1476,45824,1561,NA,44262,4397,752,49411,19087
"1220",1990,"Emmet",11592,15477,179409,1568,104,0.0539,7.5,71434,9173,7216,1957,63334,4395,9160,2915,7162,27687,2507,2518,34677,1591,NA,1627,0,80607,63334,17273,1591,18864,1103,0,17761,1459,199,19419,43747
"1221",1990,"Fayette",21889,14758,323040,1250,92,0.0539,7.5,179002,15891,11370,4521,148466,21794,18642,5648,15664,119925,5129,8193,73396,2585,-201,2786,0,194893,148466,46427,2585,49012,3844,NA,45167,4993,741,50901,59077
"1222",1990,"Floyd",17056,16501,281436,1238,98,0.0539,7.5,104322,12359,9486,2873,87413,8759,11107,4460,10316,45369,3457,4745,44569,2097,58,2039,0,116681,87413,29268,2097,31365,3909,0,27456,3095,428,30979,58953
"1223",1990,"Franklin",11351,16004,181662,1532,114,0.0539,7.5,129555,14549,11284,3265,119787,16556,15380,5216,12977,65532,4234,5824,59600,2573,142,2431,0,144104,119787,24317,2573,26890,2135,0,24755,3163,426,28344,64023
"1224",1990,"Fremont",8236,14903,122738,983,90,0.0539,7.5,79873,9205,5994,3211,77913,5380,12817,3270,8582,35507,2452,4636,40776,1444,-113,1557,0,89078,77913,11165,1444,12609,1412,0,11197,2797,363,14357,44366
"1225",1990,"Greene",10028,15850,158940,1462,101,0.0539,7.5,99259,15874,7859,8015,97726,6987,9933,4874,12189,37461,3283,5396,55064,2033,-63,2096,0,115133,97726,17407,2033,19440,2354,0,17086,2926,403,20415,61798
"1226",1990,"Grundy",12017,17861,214637,1606,124,0.0539,7.5,136601,15717,8600,7117,126844,15048,24363,4605,13749,74168,3625,6903,58551,2197,NA,2176,0,152318,126844,25474,2197,27671,4782,0,22889,3603,493,26985,62433
"1227",1990,"Guthrie",10941,16034,175426,1084,88,0.0539,7.5,85262,10471,6653,3818,79403,10042,9550,3051,8916,48290,2754,4097,40993,1352,-145,1497,0,95733,79403,16330,1352,17682,897,0,16785,2477,389,19651,36972
"1228",1990,"Hamilton",16049,17347,278399,1717,112,0.0539,7.5,146995,11976,8752,3224,141772,28858,17547,5156,12189,85283,4440,7747,65835,2463,283,2180,0,158971,141772,17199,2463,19662,2029,0,17633,5368,669,23670,61712
"1229",1990,"Hancock",12610,16102,203048,1519,113,0.0539,7.5,122231,14029,9849,4180,113391,13224,14083,5238,12241,57784,4429,4472,59704,2606,144,2462,0,136260,113391,22869,2606,25475,1641,0,23834,2450,349,26633,64447
"1230",1990,"Hardin",19099,16773,320345,1578,109,0.0539,7.5,147618,13831,9630,4201,133238,22688,20985,5072,13248,86370,4173,6179,60893,2454,145,2309,0,161449,133238,28211,2454,30665,2840,0,27825,3394,507,31726,61248
"1231",1990,"Harrison",14734,14222,209547,1026,94,0.0539,7.5,95749,9921,7675,2246,95984,6128,12164,4936,13190,39320,3464,4281,51821,1801,-216,2017,0,105670,95984,9686,1801,11487,777,0,10710,2197,311,13218,56429
"1232",1990,"Henry",19296,16382,316100,1098,NA,0.0539,7.5,72449,9267,6643,2624,66088,9939,5909,2881,7616,38425,2115,3117,34511,1284,NA,1267,0,81716,66088,15628,1284,16912,1630,0,15282,1679,236,17197,34024
"1233",1990,"Howard",9811,15257,149687,955,80,0.0539,7.5,87635,10931,7689,3242,78246,10529,7856,3754,9743,50568,3101,3770,39493,1488,-98,1586,0,98566,78246,20320,1488,21808,1001,0,20807,2002,300,23109,37067
"1234",1990,"Humboldt",10755,16307,175380,1669,115,0.0539,7.5,94532,9556,6470,3086,87187,7356,11434,4212,10204,39604,2718,2992,48271,1863,NA,1823,0,104088,87187,16901,1863,18764,1029,0,17735,1723,234,19692,54928
"1235",1990,"Ida",8341,16230,135375,1401,89,0.0539,7.5,99643,8105,5908,2197,86976,8889,18827,3330,8561,58072,2449,3656,41264,1671,-126,1797,0,107748,86976,20772,1671,22443,1282,0,21161,1884,264,23309,41571
"1236",1990,"Iowa",14618,17596,257219,1179,90,0.0539,7.5,108945,11519,8445,3074,98899,13371,16614,3866,9833,70887,3245,5385,46585,1438,-177,1615,0,120464,98899,21565,1438,23003,2209,0,20794,3360,454,24608,38058
"1237",1990,"Jackson",19909,14843,295501,1099,85,0.0539,7.5,124466,11025,7337,3688,114638,18042,26516,2680,7480,105328,3448,4382,52090,1019,-566,1585,0,135491,114638,20853,1019,21872,1067,0,20805,2679,455,23939,19138
"1238",1990,"Jasper",34829,18141,631830,1225,97,0.0539,7.5,148809,13378,9040,4338,129696,18060,18554,5460,13681,90849,4002,5792,64147,2236,-64,2300,0,162187,129696,32491,2236,34727,4112,0,30615,3437,484,34536,57960
"1239",1990,"Jefferson",16313,15869,258864,842,NA,0.0539,7.5,58879,7426,5493,1933,51831,5644,5239,2387,6222,31939,2041,2375,27923,1019,-75,1094,0,66305,51831,14474,1019,15493,1241,0,14252,1318,187,15757,26940
"1240",1990,"Johnson",96595,18074,1745829,1409,94,0.0539,7.5,120169,12177,7354,4823,106156,20379,13753,3886,10138,81764,3558,4610,49832,1724,NA,1725,0,132346,106156,26190,1724,27914,2552,0,25362,2649,389,28400,38405
"1241",1990,"Jones",19480,14495,282362,1170,100,0.0539,7.5,149194,11957,8151,3806,134880,21241,28163,4503,12129,110377,4218,5538,59088,1853,-123,1976,0,161151,134880,26271,1853,28124,3727,0,24397,3018,479,27894,38817
"1242",1990,"Keokuk",11601,15547,180359,1065,NA,0.0539,7.5,98983,11502,9618,1884,87323,14088,9087,3624,10389,63939,3314,3700,43121,1602,55,1547,0,110485,87323,23162,1602,24764,2233,0,22531,2083,301,24915,35044
"1243",1990,"Kossuth",18551,16204,300601,1612,114,0.0539,7.5,208311,23005,16294,6711,193404,17191,21938,9900,22078,88786,7856,8589,105852,4432,126,4306,0,231316,193404,37912,4432,42344,2563,NA,39780,5004,705,45489,119525
"1244",1990,"Lee",38632,15992,617812,936,NA,0.0539,7.5,76564,6803,4188,2615,71226,9969,10418,2920,7498,51211,2432,3579,34410,993,NA,1042,0,83367,71226,12141,993,13134,1421,0,11713,2279,352,14344,25353
"1245",1990,"Linn",169295,19883,3366118,1465,96,0.0539,7.5,117620,11942,7591,4351,109813,11714,12720,4896,11927,62050,3941,6301,58314,1916,-146,2062,0,129562,109813,19749,1916,21665,2540,0,19125,3294,469,22888,55570
"1246",1990,"Louisa",11620,15705,182491,1320,NA,0.0539,7.5,56239,8543,6425,2118,50512,4368,3559,2774,6944,21346,1991,2636,28240,1334,NA,1324,0,64782,50512,14270,1334,15604,1925,0,13679,1469,204,15352,34893
"1247",1990,"Lucas",9059,15417,139660,549,NA,0.0539,7.5,27864,5651,3978,1673,29334,3817,2589,901,2564,19852,1159,1365,16939,218,-276,494,0,33515,29334,4181,218,4399,215,0,4184,631,103,4918,8012
"1248",1990,"Lyon",11978,14844,177796,1395,87,0.0539,7.5,185980,12853,7023,5830,156683,26558,46864,4528,9945,140817,3833,5814,59141,1621,-276,1897,0,198833,156683,42150,1621,43771,9271,NA,34499,3640,534,38673,45163
"1249",1990,"Madison",12516,16010,200379,905,87,0.0539,7.5,70707,8021,4625,3396,70783,12258,6955,2444,6444,44830,2122,4132,36428,844,-266,1110,0,78728,70783,7945,844,8789,556,0,8233,2547,332,11112,25877
"1250",1990,"Mahaska",21563,15723,339032,1047,NA,0.0539,7.5,135504,11663,8117,3546,117427,19441,21333,3889,9961,95720,3506,5581,53716,1726,NA,1678,0,147167,117427,29740,1726,31466,2617,0,28849,3343,463,32655,39784
"1251",1990,"Marion",29995,16960,508729,955,NA,0.0539,7.5,75233,7273,4791,2482,68140,8585,8581,3091,6427,45940,2193,4113,35150,1057,-64,1121,0,82506,68140,14366,1057,15423,1097,0,14326,2138,321,16785,29293
"1252",1990,"Marshall",38301,17986,688887,1349,104,0.0539,7.5,107640,16635,9189,7446,99708,9913,11918,4751,12055,50801,3638,6153,51280,2048,-50,2098,0,124275,99708,24567,2048,26615,3634,0,22981,3943,549,27473,56839
"1253",1990,"Mills",13168,18681,245989,997,90,0.0539,7.5,65633,7832,5193,2639,65579,4676,9726,2980,7687,26597,2056,4264,34190,1311,-85,1396,0,73465,65579,7886,1311,9197,867,0,8330,2670,348,11348,39036
"1254",1990,"Mitchell",10919,18154,198224,1180,93,0.0539,7.5,126460,11172,7190,3982,103299,17046,19074,3995,9058,80252,3562,5153,45411,1922,NA,1927,0,137632,103299,34333,1922,36255,1854,0,34401,2876,402,37679,46208
"1255",1990,"Monona",10003,14706,147107,1019,84,0.0539,7.5,97535,11602,8034,3568,95748,6573,15422,4527,12585,44461,3188,4423,49030,1817,-194,2011,0,109137,95748,13389,1817,15206,838,0,14368,2269,319,16956,53074
"1256",1990,"Monroe",8130,15493,125957,647,NA,0.0539,7.5,33887,4099,3091,1008,34921,4306,5758,942,2541,26047,1272,1483,18619,275,-278,553,0,37986,34921,3065,275,3340,100,0,3240,886,151,4277,7840
"1257",1990,"Montgomery",12074,16723,201909,907,90,0.0539,7.5,66411,8997,5262,3735,62630,5349,9567,2512,6723,30439,2369,4513,31597,1142,-139,1281,0,75408,62630,12778,1142,13920,838,0,13082,2988,379,16449,35972
"1258",1990,"Muscatine",39969,18619,744180,1369,100,0.0539,7.5,73832,7526,5412,2114,68716,8652,6324,3028,7652,37948,2529,3194,37337,1261,NA,1296,0,81358,68716,12642,1261,13903,1863,0,12040,1970,279,14289,35884
"1259",1990,"O'Brien",15451,16998,262630,1755,95,0.0539,7.5,179884,13635,8290,5345,147467,24414,30808,5203,13045,112089,4179,5431,64387,2573,99,2474,0,193519,147467,46052,2573,48625,3667,NA,44957,3147,456,48560,67795
"1260",1990,"Osceola",7285,15712,114463,1532,84,0.0539,7.5,103374,10141,6513,3628,90946,11772,15749,3638,8508,57042,3152,3842,44285,1616,NA,1644,0,113515,90946,22569,1616,24185,3237,0,20948,2119,300,23367,46332
"1261",1990,"Page",16874,16422,277111,811,75,0.0539,7.5,87984,9564,5500,4064,79250,6859,10064,4111,7829,42460,2441,6796,41150,1334,-188,1522,0,97548,79250,18298,1334,19632,1048,0,18584,4637,616,23837,45524
"1262",1990,"Palo Alto",10642,15688,166951,1501,107,0.0539,7.5,117319,14554,10125,4429,102691,9962,15297,4483,11319,52086,3736,3993,53901,2449,58,2391,0,131873,102691,29182,2449,31631,3065,0,28566,2184,294,31044,65233
"1263",1990,"Plymouth",23382,16613,388450,1362,87,0.0539,7.5,244970,16311,10375,5936,215017,33083,59294,6661,16298,174050,5942,7785,85954,2852,-67,2919,0,261281,215017,46264,2852,49116,2329,NA,46786,4043,637,51466,70920
"1264",1990,"Pocahontas",9493,15492,147061,1644,95,0.0539,7.5,109821,11377,8774,2603,106749,10373,13301,5092,11809,49554,3554,3997,58623,2292,69,2223,0,121198,106749,14449,2292,16741,1220,0,15521,2191,312,18024,60267
"1265",1990,"Polk",328531,21609,7099359,1367,101,0.0539,7.5,61883,8501,4956,3545,60032,3449,3775,3529,7641,18216,2173,4131,35334,1341,NA,1389,0,70384,60032,10352,1341,11693,1679,0,10014,2639,353,13006,43667
"1266",1990,"Pottawattamie",82697,15767,1303871,1057,93,0.0539,7.5,184271,16808,11357,5451,169846,12975,33794,7189,18205,96444,5639,8395,83649,2875,-356,3231,0,201079,169846,31233,2875,34108,3576,NA,30531,4625,652,35808,87827
"1267",1990,"Poweshiek",19035,17186,327139,1175,92,0.0539,7.5,98157,11334,8714,2620,87848,10449,10440,3642,9378,54828,3257,3128,47554,1645,-176,1821,0,109491,87848,21643,1645,23288,1323,0,21965,1811,301,24077,43329
"1268",1990,"Ringgold",5416,13641,73877,566,72,0.0539,7.5,42704,7307,6031,1276,42400,5264,4625,1400,4103,29873,1781,1671,23556,388,-319,707,0,50011,42400,7611,388,7999,260,0,7739,842,148,8729,12831
"1269",1990,"Sac",12311,15271,187999,1589,100,0.0539,7.5,160293,10722,7127,3595,142914,20711,32566,4940,12338,104655,4029,6965,61365,2203,NA,2219,0,171015,142914,28101,2203,30304,4367,NA,25936,4001,543,30480,55638
"1270",1990,"Scott",151304,18617,2816805,1845,115,0.0539,7.5,104934,10984,5700,5284,91597,10585,12146,3955,10175,58118,3401,4570,46765,1774,NA,1747,0,115918,91597,24321,1774,26095,4163,0,21932,2848,436,25216,46816
"1271",1990,"Shelby",13235,16167,213973,1120,90,0.0539,7.5,139017,10769,8227,2542,120773,15509,21589,4786,12924,81876,3882,4207,57876,2314,NA,2355,0,149786,120773,29013,2314,31327,1873,0,29454,2495,352,32301,57141
"1272",1990,"Sioux",29927,15913,476236,1510,87,0.0539,7.5,468370,23479,11464,12015,398002,82474,155958,7538,18349,394250,6893,13935,112855,2453,-603,3056,0,491849,398002,93847,2453,96300,15313,NA,80985,8208,1195,90388,74120
"1273",1990,"Story",74382,16265,1209815,1608,101,0.0539,7.5,109969,14631,8235,6396,105419,11385,13601,4429,10923,49483,3237,7214,54630,2184,NA,2149,0,124600,105419,19181,2184,21365,2937,0,18428,3902,515,22845,60486
"1274",1990,"Tama",17436,16266,283612,1275,101,0.0539,7.5,123602,15270,11325,3945,115786,11768,12603,5437,15425,59614,4168,5726,60659,2265,-133,2398,0,138872,115786,23086,2265,25351,1764,0,23587,3066,412,27065,63988
"1275",1990,"Taylor",7103,12810,90989,647,71,0.0539,7.5,47412,9225,6593,2632,49414,5246,5941,2010,5130,29473,1911,2753,26423,721,-209,930,0,56637,49414,7223,721,7944,297,0,7647,1497,232,9376,17939
"1276",1990,"Union",12774,15071,192512,678,68,0.0539,7.5,49227,6422,4189,2233,48335,7825,8480,1390,3844,32571,1562,2456,22778,403,-345,748,0,55649,48335,7314,403,7717,435,0,7282,1433,228,8943,16656
"1277",1990,"Van Buren",7683,13824,106213,699,NA,0.0539,7.5,40604,6699,4849,1850,36948,4670,3169,1465,4015,24311,1387,1713,20529,590,-142,732,0,47303,36948,10355,590,10945,892,0,10053,1048,155,11256,16293
"1278",1990,"Wapello",35733,15484,553294,757,NA,0.0539,7.5,41770,5655,4018,1637,39643,4110,5061,1525,4370,22527,1483,1769,21325,804,-121,925,0,47425,39643,7782,804,8586,595,0,7991,913,141,9045,19243
"1279",1990,"Warren",36170,16243,587497,966,84,0.0539,7.5,62747,7559,4745,2814,62898,6381,6002,2645,5946,37253,2321,3645,35958,909,-224,1133,0,70306,62898,7408,909,8317,690,0,7627,1892,321,9840,25494
"1280",1990,"Washington",19617,16917,331855,1368,NA,0.0539,7.5,151523,11676,8569,3107,133638,32493,16286,4312,10802,107317,4061,6482,59202,2229,308,1921,0,163199,133638,29561,2229,31790,5261,0,26529,3857,542,30928,44206
"1281",1990,"Wayne",7075,13544,95821,544,NA,0.0539,7.5,37163,8929,6604,2325,41071,3742,4046,1574,4633,23241,1561,1698,23817,477,-261,738,0,46092,41071,5021,477,5498,175,0,5323,612,107,6042,13922
"1282",1990,"Webster",40345,16108,649889,1681,116,0.0539,7.5,123116,16950,9810,7140,121158,14841,8202,5515,13747,46151,3943,6001,68909,2623,94,2529,0,140066,121158,18908,2623,21531,1540,0,19991,4010,530,24531,76965
"1283",1990,"Winnebago",12131,16651,201999,1399,107,0.0539,7.5,70968,11819,9112,2707,62729,4799,4083,3629,8218,23060,2869,2627,36504,1893,81,1812,0,82787,62729,20058,1893,21951,2659,0,19292,1231,206,20729,47908
"1284",1990,"Winneshiek",20840,15825,329798,989,89,0.0539,7.5,155911,14976,9325,5651,127506,21902,17504,3969,9204,129589,4322,6270,64335,1526,-484,2010,0,170887,127506,43381,1526,44907,1245,0,43662,3464,573,47699,26322
"1285",1990,"Woodbury",98506,17170,1691383,1119,82,0.0539,7.5,160640,18805,12402,6403,154477,16890,44390,5490,15230,103118,3947,6369,62161,2172,-307,2479,0,179445,154477,24968,2172,27140,1189,NA,25950,3253,486,29689,57522
"1286",1990,"Worth",7980,16678,133090,1340,98,0.0539,7.5,74967,11293,8130,3163,64576,8144,6551,3353,8022,30191,2846,2020,33640,1636,NA,1610,0,86260,64576,21684,1636,23320,1104,0,22216,1136,176,23528,44776
"1287",1990,"Wright",14272,16220,231497,1722,116,0.0539,7.5,103133,15492,9808,5684,97338,6627,7251,5246,12614,30140,3503,4764,57333,2563,65,2498,0,118625,97338,21287,2563,23850,1996,0,21854,2571,341,24766,72993
"1288",1991,"Adair",8430,15669,132092,753,87,0.0425,5.38,85151,8077,5434,2643,75807,8613,8805,3847,9766,44889,2478,3063,39235,-5136,NA,-5169,NA,93228,75807,17421,-5136,12285,976,0,11309,1352,208,12869,40262
"1289",1991,"Adams",4748,15302,72652,781,89,0.0425,5.38,51580,5196,3936,1260,43410,5004,4695,1806,4990,27596,1676,1597,23642,-2979,NA,-2960,NA,56776,43410,13366,-2979,10387,393,0,9994,736,122,10852,23984
"1290",1991,"Allamakee",13996,14617,204582,735,95,0.0425,5.38,100683,9327,5665,3662,86717,16430,9317,2733,6348,85953,2878,4258,44753,-3872,132,-3995,NA,110010,86717,23293,-3872,19421,427,0,18994,2139,359,21492,14730
"1291",1991,"Appanoose",13768,13844,190608,526,NA,0.0425,5.38,28296,3955,2923,1032,28860,2680,3001,1117,3311,16335,1068,1015,16668,-1625,-314,-1308,NA,32251,28860,3391,-1625,1766,NA,0,1722,515,100,2337,11961
"1292",1991,"Audubon",7251,16803,121836,1222,107,0.0425,5.38,106198,8874,6030,2844,90752,11568,18793,3607,9420,60048,2695,3213,41456,-4496,575,-5063,NA,115072,90752,24320,-4496,19824,587,0,19237,1791,277,21305,46150
"1293",1991,"Benton",22526,16159,364006,1416,100,0.0425,5.38,160711,14218,8785,5433,151083,20460,25966,5913,17397,88772,4176,5463,71708,-5327,516,-5828,NA,174929,151083,23846,-5327,18519,1553,0,16966,3139,466,20571,71939
"1294",1991,"Black Hawk",125601,16716,2099586,1501,114,0.0425,5.38,119108,11320,6783,4537,108843,13325,10451,5828,14608,59545,3791,6584,54256,-4693,877,-5558,NA,130428,108843,21585,-4693,16892,2184,0,14708,4164,589,19461,59563
"1295",1991,"Boone",25335,17922,454058,1540,103,0.0425,5.38,107338,8809,6172,2637,96109,9370,11350,5108,12042,41337,2840,5137,50262,-5144,420,-5555,NA,116147,96109,20038,-5144,14894,2904,0,11990,2872,408,15270,66001
"1296",1991,"Bremer",22931,16602,380709,1298,112,0.0425,5.38,97953,8704,5129,3575,86202,10615,6515,4563,11575,53777,3121,3847,45966,-5054,351,-5396,NA,106657,86202,20455,-5054,15401,846,0,14555,2090,340,16985,44176
"1297",1991,"Buchanan",20902,15530,324615,1317,112,0.0425,5.38,135659,10935,7738,3197,117991,13528,11440,6167,16052,67507,4238,6273,60293,-7018,1007,-8013,NA,146594,117991,28603,-7018,21585,1455,0,20130,4083,616,24829,68152
"1298",1991,"Buena Vista",20076,16345,328145,1648,97,0.0425,5.38,168474,10794,6849,3945,144918,28373,25285,5502,13846,101299,3647,6252,62013,-4992,1164,-6140,NA,179268,144918,34350,-4992,29358,2349,0,27009,3557,492,31058,67175
"1299",1991,"Butler",15788,15715,248103,1371,106,0.0425,5.38,130908,11728,8355,3373,110140,16035,13148,5426,13324,71499,3986,4877,53344,-5319,1144,-6451,NA,142636,110140,32496,-5319,27177,2118,0,25059,2757,413,28229,59409
"1300",1991,"Calhoun",11497,15060,173147,1672,101,0.0425,5.38,113193,10156,6468,3688,107925,11018,13268,5663,14354,46298,3211,3083,57328,-4944,640,-5574,NA,123349,107925,15424,-4944,10480,466,0,10014,1603,235,11852,66895
"1301",1991,"Carroll",21429,17218,368967,1529,105,0.0425,5.38,210591,11396,5885,5511,183730,31364,54212,5539,13658,145990,4318,5527,69112,-5414,1487,-6885,NA,221987,183730,38257,-5414,32843,1566,NA,31278,2855,455,34588,64601
"1302",1991,"Cass",15062,16365,246488,1017,94,0.0425,5.38,104689,8998,5787,3211,93731,8905,15938,4421,11602,53937,3010,3737,46118,-5763,128,-5882,NA,113687,93731,19956,-5763,14193,872,0,13321,2045,297,15663,50752
"1303",1991,"Cedar",17505,17339,303527,1560,113,0.0425,5.38,134596,12502,8831,3671,126411,15755,14277,5954,15440,70597,4348,5669,64968,-5821,1107,-6915,NA,147098,126411,20687,-5821,14866,1589,0,13277,3204,471,16952,63999
"1304",1991,"Cerro Gordo",47206,17384,820623,1421,106,0.0425,5.38,103015,11514,8687,2827,93445,8842,5309,5559,13911,36580,4026,5785,50013,-5690,678,-6358,NA,114529,93445,21084,-5690,15394,1459,0,13935,3219,450,17604,66435
"1305",1991,"Cherokee",14062,16943,238256,1409,97,0.0425,5.38,149817,10920,6192,4728,122351,14827,22462,4945,11752,82015,3701,4636,60028,-5858,793,-6640,NA,160737,122351,38386,-5858,32528,2080,0,30448,2600,376,33424,67802
"1306",1991,"Chickasaw",13219,15880,209917,1060,94,0.0425,5.38,112698,10200,6770,3430,98911,11894,15498,4829,12086,65830,3429,4340,46835,-5185,576,-5751,NA,122898,98911,23987,-5185,18802,1195,0,17607,2158,325,20090,46868
"1307",1991,"Clarke",8353,14142,118132,614,82,0.0425,5.38,30845,5001,3747,1254,30068,3284,3007,993,2787,19004,1189,936,17872,-1632,-128,-1501,NA,35846,30068,5778,-1632,4146,169,0,3977,520,74,4571,11841
"1308",1991,"Clay",17638,16642,293528,1521,94,0.0425,5.38,111775,10055,7443,2612,101489,12181,14065,4612,11080,54684,3087,5810,50654,-4564,470,-5024,NA,121830,101489,20341,-4564,15777,1875,0,13902,3315,457,17674,57091
"1309",1991,"Clayton",18889,15356,290056,932,97,0.0425,5.38,181160,16193,8810,7383,151893,28052,13936,5243,12953,142904,5011,7459,79239,-7061,1057,-8102,NA,197353,151893,45460,-7061,38399,1651,NA,36749,4102,652,41503,38256
"1310",1991,"Clinton",51064,16796,857657,1270,102,0.0425,5.38,144425,15051,10685,4366,135236,14167,26612,5517,16620,84252,4213,5579,62528,-6986,558,-7532,NA,159476,135236,24240,-6986,17254,1499,0,15755,3082,514,19351,60173
"1311",1991,"Crawford",16739,14880,249084,1265,89,0.0425,5.38,140824,10956,7754,3202,127484,15180,21526,5313,14629,76289,3619,4730,62487,-6951,579,-7518,NA,151780,127484,24296,-6951,17345,856,0,16489,2626,428,19543,64535
"1312",1991,"Dallas",30578,18940,579135,1248,96,0.0425,5.38,95652,10914,6076,4838,86182,5328,6411,4422,11319,31309,2558,5429,50715,-5713,196,-5902,NA,106566,86182,20384,-5713,14671,1547,0,13124,3440,520,17084,64343
"1313",1991,"Davis",8321,13390,111418,648,NA,0.0425,5.38,42480,5623,4120,1503,42164,6370,3807,1440,4076,28175,1429,1618,23424,-1910,-230,-1676,NA,48103,42164,5939,-1910,4029,199,0,3830,930,162,4922,14305
"1314",1991,"Decatur",8185,12704,103986,507,68,0.0425,5.38,43042,5972,4150,1822,41461,6736,8308,1055,2989,31858,1325,1954,19094,-1497,-139,-1354,NA,49014,41461,7553,-1497,6056,387,0,5669,1215,172,7056,11184
"1315",1991,"Delaware",18139,15271,277004,1395,114,0.0425,5.38,212193,11977,8032,3945,184550,40494,25018,5823,14705,173637,6059,6809,85642,-6220,2571,-8772,NA,224170,184550,39620,-6220,33400,2117,NA,31284,3753,629,35666,38556
"1316",1991,"Des Moines",42871,17800,763122,1167,NA,0.0425,5.38,54395,6385,3808,2577,50486,4625,2607,2908,7309,20865,1661,2276,29100,-2267,169,-2431,NA,60780,50486,10294,-2267,8027,936,0,7091,1186,199,8476,33530
"1317",1991,"Dickinson",15196,18684,283925,1400,88,0.0425,5.38,77891,6989,4807,2182,71210,8333,14573,3165,7722,39800,2021,3100,32296,-3146,76,-3215,NA,84880,71210,13670,-3146,10524,1109,0,9415,1565,223,11203,38091
"1318",1991,"Dubuque",86988,17392,1512920,1250,109,0.0425,5.38,206723,10492,5751,4741,179914,40319,29207,4531,11823,186750,5140,7258,81636,-5065,1367,-6414,NA,217215,179914,37301,-5065,32236,1046,NA,31191,3825,664,35680,19973
"1319",1991,"Emmet",11666,15264,178066,1567,106,0.0425,5.38,67386,7627,6004,1623,62723,4217,8276,3247,7983,25456,2450,2424,34126,-3686,223,-3903,NA,75013,62723,12290,-3686,8604,481,0,8123,1397,194,9714,41930
"1320",1991,"Fayette",22065,14725,324905,1209,105,0.0425,5.38,179440,13757,9594,4163,146976,21844,15997,6331,17679,111294,4930,7842,72353,-8923,928,-9835,NA,193197,146976,46221,-8923,37298,2601,NA,34698,4761,718,40177,68146
"1321",1991,"Floyd",16950,16796,284694,1227,101,0.0425,5.38,103133,9750,7155,2595,87615,8513,10082,5034,11599,42899,3337,4516,44534,-5057,646,-5694,NA,112883,87615,25268,-5057,20211,2310,0,17901,2954,419,21274,60234
"1322",1991,"Franklin",11314,15499,175361,1512,114,0.0425,5.38,124798,11662,8617,3045,118870,16303,13823,5879,14369,60724,4119,5332,59045,-4825,960,-5772,NA,136460,118870,17590,-4825,12765,940,0,11825,2892,401,15118,64074
"1323",1991,"Fremont",8194,15721,128819,1000,84,0.0425,5.38,87621,8088,4919,3169,78138,5215,10997,3602,10013,30430,2336,4492,41483,-4781,80,-4854,NA,95709,78138,17571,-4781,12790,1396,0,11394,2607,355,14356,57191
"1324",1991,"Greene",10110,16478,166595,1456,107,0.0425,5.38,107830,15071,6693,8378,98271,6674,8880,5533,13787,33885,3107,5025,55265,-5889,269,-6149,NA,122901,98271,24630,-5889,18741,2153,0,16588,2691,393,19672,73945
"1325",1991,"Grundy",11957,18624,222682,1592,131,0.0425,5.38,138602,14258,6862,7396,123310,14926,20777,5111,15316,65603,3330,6557,57293,-5653,667,-6308,NA,152860,123310,29550,-5653,23897,3739,0,20158,3341,475,23974,72999
"1326",1991,"Guthrie",11101,16306,181014,1084,93,0.0425,5.38,90461,9182,6098,3084,81223,10799,8557,3513,10286,45752,2624,4154,41290,-4379,303,-4674,NA,99643,81223,18420,-4379,14041,645,0,13396,2586,405,16387,44709
"1327",1991,"Hamilton",16098,18173,292544,1699,112,0.0425,5.38,153048,10253,7467,2786,139660,27972,14401,5888,13729,81208,4274,7473,65923,-4941,1249,-6174,NA,163301,139660,23641,-4941,18700,1780,0,16920,5098,667,22685,71840
"1328",1991,"Hancock",12496,15175,189631,1499,113,0.0425,5.38,113742,12250,8109,4141,112423,13177,12360,5873,13412,54483,4308,4029,59264,-4873,921,-5783,NA,125992,112423,13569,-4873,8696,523,0,8173,2122,322,10617,59259
"1329",1991,"Hardin",19032,16790,319551,1562,110,0.0425,5.38,150853,11676,7798,3878,132681,23693,18274,5614,14826,83623,4080,5812,60382,-5375,1195,-6555,NA,162529,132681,29848,-5375,24473,2088,0,22385,3085,471,25941,67230
"1330",1991,"Harrison",14712,14869,218746,1033,90,0.0425,5.38,102191,8540,6299,2241,96801,5881,10671,5593,14990,34928,3357,4033,52276,-6341,86,-6418,NA,110731,96801,13930,-6341,7589,484,0,7105,1981,287,9373,67263
"1331",1991,"Henry",19490,16642,324349,1126,NA,0.0425,5.38,71404,7505,5322,2183,65191,9614,5044,3269,8449,35828,1986,2919,33910,-2760,439,-3192,NA,78909,65191,13718,-2760,10958,1023,0,9935,1486,219,11640,35576
"1332",1991,"Howard",9910,15296,151580,935,88,0.0425,5.38,86623,10071,6939,3132,78124,10542,6696,4296,10954,46621,2987,3485,39164,-4105,375,-4471,NA,96694,78124,18570,-4105,14465,629,0,13836,1819,278,15933,40002
"1333",1991,"Humboldt",10687,16088,171932,1648,116,0.0425,5.38,89557,8302,5225,3077,87444,7263,9562,4797,11664,36235,2650,2641,48867,-2990,506,-3488,NA,97859,87444,10415,-2990,7425,398,0,7027,1457,207,8691,53322
"1334",1991,"Ida",8286,16004,132612,1405,87,0.0425,5.38,97831,7221,5166,2055,85086,8640,15693,3713,9610,51162,2352,3339,41739,-5039,413,-5445,NA,105052,85086,19966,-5039,14927,857,0,14070,1657,247,15974,46669
"1335",1991,"Iowa",14744,18479,272455,1189,91,0.0425,5.38,104658,11094,8094,3000,96573,13144,14573,4274,10741,63904,3104,5146,45591,-4629,491,-5110,NA,115752,96573,19179,-4629,14550,1277,0,13273,3143,440,16856,40754
"1336",1991,"Jackson",19912,14637,291457,1088,90,0.0425,5.38,110549,10800,7033,3767,114692,18795,23656,2972,8371,94886,3341,4104,53453,-3897,172,-4058,NA,121349,114692,6657,-3897,2760,130,0,2630,2456,406,5492,15663
"1337",1991,"Jasper",34791,18273,635720,1242,103,0.0425,5.38,147818,12405,8355,4050,129587,17919,16534,6121,15338,84283,3791,5394,64490,-5583,1003,-6573,NA,160223,129587,30636,-5583,25053,2866,0,22187,3168,463,25818,63535
"1338",1991,"Jefferson",16316,15869,258912,864,NA,0.0425,5.38,58660,6435,4687,1748,52126,5764,4727,2653,6667,30159,1884,2246,28185,-2437,239,-2671,NA,65095,52126,12969,-2437,10532,768,0,9764,1238,182,11184,28501
"1339",1991,"Johnson",97484,18828,1835413,1449,94,0.0425,5.38,112838,11562,6921,4641,104223,20017,12107,4312,11119,75721,3389,4193,49086,-3715,931,-4634,NA,124400,104223,20177,-3715,16462,1393,0,15069,2364,363,17796,37117
"1340",1991,"Jones",19607,14252,279446,1185,100,0.0425,5.38,142543,11022,7282,3740,132382,21300,24013,5018,13555,101736,4079,5173,59244,-5155,1070,-6212,NA,153565,132382,21183,-5155,16028,2027,0,14001,2789,446,17236,40807
"1341",1991,"Keokuk",11617,15832,183916,1087,NA,0.0425,5.38,98029,10894,9284,1610,85802,14302,8021,3911,10947,59831,2991,3413,42217,-3184,1001,-4175,NA,108923,85802,23121,-3184,19937,1803,0,18134,1823,277,20234,38198
"1342",1991,"Kossuth",18230,15057,274489,1590,114,0.0425,5.38,184056,18467,12489,5978,184566,15276,19163,10774,23483,81247,7225,7777,100868,-7525,1195,-8702,NA,202523,184566,17957,-7525,10432,621,NA,9812,4671,679,15162,102809
"1343",1991,"Lee",38913,16330,635452,968,NA,0.0425,5.38,77272,5976,3534,2442,72188,10072,9460,3296,8252,48167,2374,3618,35116,-2304,526,-2823,NA,83248,72188,11060,-2304,8756,917,0,7839,2277,350,10466,29105
"1344",1991,"Linn",171320,20450,3503412,1506,98,0.0425,5.38,109390,11381,7333,4048,107762,11649,10453,5342,13233,55858,3722,5835,57528,-4704,418,-5112,NA,120771,107762,13009,-4704,8305,914,0,7391,2927,440,10758,53532
"1345",1991,"Louisa",11644,15615,181824,1358,NA,0.0425,5.38,50165,7677,5571,2106,49775,4236,3097,3099,7611,19028,1878,2435,27419,-2491,291,-2777,NA,57842,49775,8067,-2491,5576,652,0,4924,1314,189,6427,31137
"1346",1991,"Lucas",9166,15719,144082,574,NA,0.0425,5.38,27249,4797,3312,1485,28250,3619,2263,870,2604,17814,1048,1256,16590,-1424,-174,-1247,NA,32046,28250,3796,-1424,2372,107,0,2265,590,101,2956,9435
"1347",1991,"Lyon",11914,15352,182901,1403,88,0.0425,5.38,188470,11154,5731,5423,157631,28246,42311,5209,11417,130589,3747,5943,60758,-5696,699,-6380,NA,199624,157631,41993,-5696,36297,4070,NA,32228,3577,534,36339,57881
"1348",1991,"Madison",12548,16604,208349,921,88,0.0425,5.38,72961,7519,4023,3496,71624,12346,6416,2749,7348,42104,2043,3893,36829,-3037,NA,-3052,NA,80480,71624,8856,-3037,5819,340,0,5479,2323,326,8128,30857
"1349",1991,"Mahaska",21516,16146,347401,1075,NA,0.0425,5.38,131846,10716,7510,3206,115273,19457,18468,4274,10911,87865,3331,5203,53629,-3398,1175,-4561,NA,142562,115273,27289,-3398,23891,2042,0,21849,3012,443,25304,43981
"1350",1991,"Marion",30183,17266,521132,989,NA,0.0425,5.38,74047,6455,4324,2131,67217,8371,7966,3386,7030,41984,2000,3828,34636,-2523,455,-2972,NA,80502,67217,13285,-2523,10762,718,0,10044,1827,295,12166,32063
"1351",1991,"Marshall",38209,18790,717936,1349,105,0.0425,5.38,112626,15742,8216,7526,99907,9779,9900,5318,13740,46633,3509,5835,51826,-6055,508,-6553,NA,128368,99907,28461,-6055,22406,2835,0,19571,3674,532,23777,65993
"1352",1991,"Mills",13227,19564,258775,1014,88,0.0425,5.38,71880,6426,4289,2137,66439,4460,8395,3383,8811,22933,2010,4297,35083,-4292,100,-4386,NA,78306,66439,11867,-4292,7575,691,0,6884,2767,377,10028,48947
"1353",1991,"Mitchell",10897,17690,192770,1169,97,0.0425,5.38,122037,9663,6009,3654,102039,16790,16986,4515,10003,73951,3439,4923,45383,-4522,855,-5366,NA,131700,102039,29661,-4522,25139,1192,0,23947,2713,395,27055,48086
"1354",1991,"Monona",9978,14541,145090,1020,87,0.0425,5.38,96462,10010,6881,3129,96615,6747,13496,5059,14229,40706,3040,4264,49780,-5795,121,-5907,NA,106472,96615,9857,-5795,4062,218,0,3844,2152,313,6309,55756
"1355",1991,"Monroe",8169,15784,128943,668,NA,0.0425,5.38,31916,3530,2628,902,34090,4214,5007,932,2518,23194,1144,1392,18883,-1451,-148,-1300,NA,35446,34090,1356,-1451,-95,NA,0,-90,855,149,914,8722
"1356",1991,"Montgomery",11980,17543,210163,922,87,0.0425,5.38,70711,8405,4539,3866,61696,5104,8048,2699,7377,26976,2254,4576,31638,-3866,112,-3973,NA,79116,61696,17420,-3866,13554,834,0,12720,3061,403,16184,43735
"1357",1991,"Muscatine",40538,18786,761560,1417,93,0.0425,5.38,69279,6952,5123,1829,68221,8956,5384,3380,8276,35392,2411,2883,36931,-2870,377,-3240,NA,76231,68221,8010,-2870,5140,657,0,4483,1764,257,6504,33887
"1358",1991,"O'Brien",15530,17094,265470,1766,97,0.0425,5.38,174934,11876,6832,5044,140917,23823,24115,5750,14510,98327,3929,5032,63758,-5190,1336,-6511,NA,186810,140917,45893,-5190,40703,2893,NA,37811,2883,436,41130,76607
"1359",1991,"Osceola",7290,16258,118520,1542,87,0.0425,5.38,111677,8571,4796,3775,92219,11793,13863,4192,9807,54334,3168,3782,45614,-4397,542,-4930,NA,120248,92219,28029,-4397,23632,3231,0,20401,2088,305,22794,57343
"1360",1991,"Page",16861,16892,284823,824,72,0.0425,5.38,90975,8500,4590,3910,77952,6722,8504,4181,8807,37604,2336,6394,41008,-4284,209,-4486,NA,99475,77952,21523,-4284,17239,860,0,16379,4345,615,21339,53371
"1361",1991,"Palo Alto",10613,14382,152641,1490,108,0.0425,5.38,103320,12185,8203,3982,102019,9698,13690,4993,12569,48898,3641,3609,53819,-3605,671,-4266,NA,115505,102019,13486,-3605,9881,925,0,8956,1949,275,11180,54422
"1362",1991,"Plymouth",23470,17327,406668,1367,87,0.0425,5.38,247343,14714,9286,5428,212195,33008,53350,7511,18440,161202,5847,7470,86569,-7738,1735,-9454,NA,262057,212195,49862,-7738,42124,1879,NA,40246,3859,620,44725,86141
"1363",1991,"Pocahontas",9396,15613,146698,1627,98,0.0425,5.38,112207,9550,7249,2301,105491,9602,11342,5773,13366,45281,3443,3924,58041,-5172,617,-5779,NA,121757,105491,16266,-5172,11094,756,0,10338,2062,300,12700,66926
"1364",1991,"Polk",333568,21798,7271089,1369,105,0.0425,5.38,63027,7894,4308,3586,59979,3501,3345,3884,8271,16278,2047,3766,35165,-3453,145,-3593,NA,70921,59979,10942,-3453,7489,993,0,6496,2453,338,9287,46749
"1365",1991,"Pottawattamie",82864,16556,1371931,1069,93,0.0425,5.38,197851,14518,9640,4878,167591,12740,29186,8091,20389,85683,5383,8061,83741,-11076,290,-11352,NA,212369,167591,44778,-11076,33702,3413,NA,30290,4214,625,35129,112168
"1366",1991,"Poweshiek",18945,17703,335380,1187,101,0.0425,5.38,96549,10815,8311,2504,86964,10543,9191,4004,10317,49498,3137,2734,47038,-4378,411,-4780,NA,107364,86964,20400,-4378,16022,911,0,15111,1548,266,16925,47051
"1367",1991,"Ringgold",5405,13801,74595,586,73,0.0425,5.38,42467,6540,5467,1073,41334,5223,3892,1494,4462,26052,1709,1456,23098,-2147,-108,-2035,NA,49007,41334,7673,-2147,5526,157,0,5369,712,132,6213,16415
"1368",1991,"Sac",12156,15625,189942,1595,102,0.0425,5.38,155081,9040,5943,3097,138586,20497,27703,5598,14047,95526,3875,6229,60637,-4944,984,-5915,NA,164121,138586,25535,-4944,20591,1357,0,19234,3460,502,23196,59555
"1369",1991,"Scott",153222,19181,2938878,1923,117,0.0425,5.38,101627,10877,5616,5261,90252,10376,9918,4371,11389,52439,3245,4460,46493,-4515,676,-5182,NA,112504,90252,22252,-4515,17737,2660,0,15077,2778,422,18277,49188
"1370",1991,"Shelby",13318,16569,220669,1126,97,0.0425,5.38,144567,9168,6881,2287,120049,15386,18469,5488,14758,75546,3732,4033,58183,-7489,840,-8317,NA,153735,120049,33686,-7489,26197,1529,0,24668,2400,350,27418,69021
"1371",1991,"Sioux",30125,15982,481470,1517,94,0.0425,5.38,450355,20898,9221,11677,392476,86667,136898,8751,21376,360307,6975,13566,118243,-8292,1890,-10149,NA,471253,392476,78777,-8292,70485,4881,NA,65605,7296,1125,74026,90048
"1372",1991,"Story",74497,17050,1270178,1598,104,0.0425,5.38,114541,13304,6999,6305,103707,10704,11251,4928,12089,43519,3003,7001,54731,-6041,531,-6563,NA,127845,103707,24138,-6041,18097,2238,0,15859,3579,493,19931,71022
"1373",1991,"Tama",17424,16374,285308,1272,102,0.0425,5.38,123536,13482,9617,3865,114587,11297,10712,5991,17426,53234,3964,5369,59828,-6549,442,-6979,NA,137018,114587,22431,-6549,15882,1015,0,14867,2718,383,17968,70302
"1374",1991,"Taylor",7053,13617,96044,664,75,0.0425,5.38,51881,8348,5779,2569,49759,5160,5660,2260,5737,27191,1812,2810,26320,-2891,78,-2964,NA,60229,49759,10470,-2891,7579,246,0,7333,1507,236,9076,24690
"1375",1991,"Union",12635,15393,194495,702,82,0.0425,5.38,51508,5831,3569,2262,48234,8196,6983,1517,4282,30716,1503,2399,23354,-2796,-403,-2388,NA,57339,48234,9105,-2796,6309,340,0,5969,1397,216,7582,20792
"1376",1991,"Van Buren",7718,14009,108119,723,NA,0.0425,5.38,40506,5910,4012,1898,37343,4723,2776,1612,4293,22296,1378,1591,20970,-1712,128,-1836,NA,46416,37343,9073,-1712,7361,630,0,6731,934,144,7809,18210
"1377",1991,"Wapello",35817,16087,576198,777,NA,0.0425,5.38,41753,5091,3614,1477,38109,3921,4339,1659,4762,20401,1362,1636,20430,-1922,116,-2034,NA,46844,38109,8735,-1922,6813,456,0,6357,814,129,7300,21352
"1378",1991,"Warren",36573,17152,627294,992,91,0.0425,5.38,62016,6725,4120,2605,62789,6094,4921,2959,6622,32855,2251,3508,36434,-3075,109,-3178,NA,68741,62789,5952,-3075,2877,223,0,2654,1689,292,4635,29161
"1379",1991,"Washington",19827,17369,344367,1397,NA,0.0425,5.38,150316,10812,8036,2776,132663,33018,14811,4779,11753,104439,3775,6142,58385,-3156,1885,-5026,NA,161128,132663,28465,-3156,25309,4013,0,21296,3575,523,25394,45877
"1380",1991,"Wayne",7057,13700,96683,570,NA,0.0425,5.38,38058,8116,5783,2333,40779,3692,3111,1751,5235,20188,1459,1682,23849,-2052,-96,-1952,NA,46174,40779,5395,-2052,3343,108,0,3235,575,104,3914,17870
"1381",1991,"Webster",40335,16872,680547,1664,115,0.0425,5.38,133206,15119,7781,7338,120577,14558,7542,6211,15465,44149,3734,5520,67547,-6082,644,-6714,NA,148325,120577,27748,-6082,21666,1472,0,20194,3536,488,24218,89057
"1382",1991,"Winnebago",11940,15905,189904,1380,107,0.0425,5.38,63132,9482,6795,2687,62228,4490,3149,4071,9164,20584,2831,2520,36003,-3424,449,-3867,NA,72614,62228,10386,-3424,6962,812,0,6150,1133,190,7473,42548
"1383",1991,"Winneshiek",21065,15761,332005,956,95,0.0425,5.38,145630,13442,8249,5193,123963,22235,14429,4432,10132,116870,4054,5949,62732,-6600,380,-6967,NA,159072,123963,35109,-6600,28509,803,0,27706,3237,531,31474,28760
"1384",1991,"Woodbury",99513,17531,1744594,1121,88,0.0425,5.38,152958,17314,11034,6280,152232,16703,40398,6196,17182,91954,3794,6103,61856,-7589,358,-7934,NA,170272,152232,18040,-7589,10451,439,0,10012,3088,476,13576,61004
"1385",1991,"Worth",7908,15996,126494,1325,99,0.0425,5.38,72044,9568,6331,3237,64415,8003,5396,3814,8941,28179,2826,1846,33589,-3689,357,-4039,NA,81612,64415,17197,-3689,13508,624,0,12884,1018,160,14062,43865
"1386",1991,"Wright",14224,16208,230541,1700,117,0.0425,5.38,97578,13471,7856,5615,97991,6503,6025,5866,14213,27293,3417,4599,57368,-4520,437,-4948,NA,111049,97991,13058,-4520,8538,664,0,7874,2403,329,10606,70285
"1387",1992,"Adair",8441,17183,145042,775,85,0.0303,3.43,82293,7538,5289,2249,76696,9323,9361,3868,9635,46562,2448,3162,38899,5973,-951,6000,924,89831,76696,13135,5973,19108,1746,0,17362,1377,226,18965,35731
"1388",1992,"Adams",4687,16518,77421,800,83,0.0303,3.43,50164,5130,3976,1154,44834,5736,5066,1769,4879,28653,1658,1560,24166,3044,-663,3190,517,55294,44834,10460,3044,13504,589,0,12915,721,117,13753,21511
"1389",1992,"Allamakee",14123,15835,223639,749,93,0.0303,3.43,102970,8940,5235,3705,90883,18939,10384,2811,6340,89893,2874,4370,45165,3839,-1336,4044,1131,111910,90883,21027,3839,24866,779,0,24087,2105,372,26564,13077
"1390",1992,"Appanoose",13865,14485,200840,556,NA,0.0303,3.43,29892,3827,2844,983,29838,2980,3755,1106,3201,17524,1021,981,16794,1111,-707,1463,355,33719,29838,3881,1111,4992,163,0,4829,494,104,5427,12368
"1391",1992,"Audubon",7141,17961,128258,1255,100,0.0303,3.43,103283,8618,6032,2586,94704,12562,20573,3708,9376,61648,2677,3269,42539,6310,-577,5851,1036,111901,94704,17197,6310,23507,936,0,22571,1821,288,24680,41635
"1392",1992,"Benton",22712,17388,394906,1450,108,0.0303,3.43,165419,14569,9290,5279,155985,23421,27168,5960,17186,90212,4082,5413,72755,9497,-904,8556,1845,179988,155985,24003,9497,33500,2891,0,30609,3160,477,34246,75207
"1393",1992,"Black Hawk",126142,17679,2230035,1532,114,0.0303,3.43,123096,11106,6886,4220,111160,14257,10317,6062,14736,58202,3872,6826,55090,9834,-367,8776,1425,134202,111160,23042,9834,32876,4445,0,28431,4407,635,33473,64894
"1394",1992,"Boone",25259,19290,487246,1577,104,0.0303,3.43,110873,8751,6155,2596,98391,10511,11707,5180,11790,41250,2777,5300,51126,8931,-275,8102,1104,119624,98391,21233,8931,30164,5899,0,24265,2900,428,27593,69623
"1395",1992,"Bremer",23038,18229,419955,1322,114,0.0303,3.43,98863,8838,5268,3570,88029,11597,6298,4671,11554,54601,3156,3959,46794,7709,-577,7150,1136,107701,88029,19672,7709,27381,1764,0,25617,2222,373,28212,44262
"1396",1992,"Buchanan",20952,16472,345113,1342,109,0.0303,3.43,129260,10988,7870,3118,120288,14584,10935,6345,15892,64663,4270,6671,61591,11274,-503,10271,1506,140248,120288,19960,11274,31234,2321,0,28913,4432,700,34045,64597
"1397",1992,"Buena Vista",20299,17187,348873,1675,97,0.0303,3.43,169735,10800,6899,3901,150253,30987,26264,5655,13953,101069,3625,6222,63547,10361,-389,8785,1965,180535,150253,30282,10361,40643,6058,NA,34586,3463,498,38547,68666
"1398",1992,"Butler",15709,17213,270392,1393,102,0.0303,3.43,126910,11873,8655,3218,110850,17229,12520,5561,13046,69561,4076,4895,53523,9521,-464,8522,1463,138783,110850,27933,9521,37454,3203,0,34251,2840,437,37528,57349
"1399",1992,"Calhoun",11503,17428,200480,1707,103,0.0303,3.43,121641,10479,6840,3639,111249,11919,13210,5892,14575,46000,3259,2968,59426,10567,-295,9561,1301,132120,111249,20871,10567,31438,1404,0,30034,1498,231,31763,75641
"1400",1992,"Carroll",21483,18949,407077,1567,104,0.0303,3.43,217423,11035,5622,5413,181614,32650,55384,5352,12889,152319,4014,5056,66269,9285,-1333,8624,1994,228458,181614,46844,9285,56129,9101,NA,47029,2712,460,50201,65104
"1401",1992,"Cass",15056,17694,266396,1040,90,0.0303,3.43,104601,8856,5742,3114,96925,9728,16773,4530,11802,56483,3027,3854,47211,7676,-908,7517,1067,113457,96925,16532,7676,24208,2380,0,21828,2133,320,24281,48118
"1402",1992,"Cedar",17703,18455,326705,1595,113,0.0303,3.43,130881,12724,9391,3333,129745,17449,13531,6117,15406,68464,4537,6041,66664,10088,-619,9111,1596,143605,129745,13860,10088,23948,2722,0,21226,3459,518,25203,62417
"1403",1992,"Cerro Gordo",47060,18094,851489,1438,108,0.0303,3.43,99746,12174,9482,2692,95103,9361,5268,5776,13993,34245,4057,6070,50578,10063,-121,8961,1223,111920,95103,16817,10063,26880,2346,0,24534,3462,494,28490,65501
"1404",1992,"Cherokee",13978,17504,244670,1445,104,0.0303,3.43,140677,10730,6018,4712,125490,16145,22122,5072,11787,81507,3773,4621,61970,7932,-908,7492,1348,151407,125490,25917,7932,33849,1896,0,31953,2669,396,35018,59170
"1405",1992,"Chickasaw",13218,17172,226986,1079,93,0.0303,3.43,111166,10010,6889,3121,102235,13244,16626,4920,11915,68088,3447,4516,47567,7674,-606,7052,1228,121176,102235,18941,7674,26615,2450,0,24165,2188,340,26693,43078
"1406",1992,"Clarke",8496,14549,123606,644,NA,0.0303,3.43,30653,5194,4015,1179,30101,3504,3554,869,2490,19454,1104,912,17668,1461,-632,1770,323,35847,30101,5746,1461,7207,237,0,6970,544,78,7592,11199
"1407",1992,"Clay",17766,17750,315351,1546,98,0.0303,3.43,112553,9923,7524,2399,104308,13229,13510,4703,11016,54298,3103,6389,52358,8113,-325,7266,1172,122476,104308,18168,8113,26281,3201,0,23080,3648,513,27241,58255
"1408",1992,"Clayton",18813,16740,314926,949,106,0.0303,3.43,179265,15684,8701,6983,156990,31414,14420,5330,12802,143473,5031,7775,80218,8903,-1660,8569,1994,194949,156990,37959,8903,46862,2002,NA,44861,4302,704,49867,35792
"1409",1992,"Clinton",51405,17803,915167,1292,115,0.0303,3.43,149018,15310,11180,4130,140072,15791,29759,5508,16321,87243,4237,5626,62830,11007,-1029,10501,1535,164328,140072,24256,11007,35263,3700,0,31563,3175,550,35288,61775
"1410",1992,"Crawford",16791,16308,273828,1299,99,0.0303,3.43,137037,10642,7634,3008,131441,16525,22105,5453,14909,77378,3567,4697,64185,9603,-1108,9234,1477,147679,131441,16238,9603,25841,2089,0,23752,2613,455,26820,59659
"1411",1992,"Dallas",31360,20492,642627,1278,102,0.0303,3.43,92150,10658,6008,4650,87088,5791,6288,4525,11298,31090,2542,5850,50794,7934,-293,7341,886,102808,87088,15720,7934,23654,2076,0,21578,3733,589,25900,61060
"1412",1992,"Davis",8326,14741,122730,680,NA,0.0303,3.43,44294,5823,4416,1407,43703,7103,3977,1360,3864,29556,1392,1728,24279,1959,-676,2132,503,50117,43703,6414,1959,8373,485,0,7888,1020,184,9092,14738
"1413",1992,"Decatur",8219,13286,109196,536,73,0.0303,3.43,45094,6014,4142,1872,43249,7721,9688,983,2659,35260,1278,2045,18875,1190,-784,1510,464,51108,43249,7859,1190,9049,1515,0,7534,1296,191,9021,9834
"1414",1992,"Delaware",18271,16711,305323,1421,119,0.0303,3.43,207775,11419,7866,3553,180291,41862,24670,5587,13535,172971,5682,6437,82518,11122,-1465,10156,2431,219194,180291,38903,11122,50025,2844,NA,47182,3719,653,51554,34804
"1415",1992,"Des Moines",43014,18600,800064,1219,NA,0.0303,3.43,56193,6213,3985,2228,51141,5141,2442,2965,7184,20784,1660,2275,29474,3971,-270,3621,620,62406,51141,11265,3971,15236,2026,0,13210,1215,205,14630,35409
"1416",1992,"Dickinson",15245,20125,306808,1434,87,0.0303,3.43,77153,6673,4858,1815,74584,9272,16149,3303,7826,42026,2032,3255,32747,4668,-348,4197,819,83826,74584,9242,4668,13910,2434,0,11476,1582,234,13292,35127
"1417",1992,"Dubuque",87672,18652,1635267,1272,116,0.0303,3.43,214961,9894,5231,4663,178421,42945,29206,4349,11133,195451,4780,6719,79289,6977,-2149,6829,2297,224855,178421,46434,6977,53411,2226,NA,51186,3655,667,55508,19510
"1418",1992,"Emmet",11722,16583,194387,1593,109,0.0303,3.43,70122,7452,6089,1363,63794,4520,8948,3308,7914,26231,2505,2539,34060,5878,-281,5483,676,77574,63794,13780,5878,19658,1526,0,18132,1485,212,19829,43891
"1419",1992,"Fayette",22082,15597,344420,1232,105,0.0303,3.43,171002,13486,9593,3893,151228,24366,16584,6491,17717,113582,4962,8149,72959,11811,-966,10820,1957,184488,151228,33260,11811,45071,3189,NA,41883,5007,770,47660,57420
"1420",1992,"Floyd",17118,17442,298570,1250,104,0.0303,3.43,100795,9539,7156,2383,90052,9239,10520,5191,11586,43252,3374,4690,45452,7981,-330,7230,1081,110334,90052,20282,7981,28263,3868,0,24395,3117,449,27961,57543
"1421",1992,"Franklin",11179,17965,200830,1522,114,0.0303,3.43,129429,12358,9477,2881,121421,17901,14017,6055,14161,57871,4195,5309,59783,11974,NA,10409,1549,141787,121421,20366,11974,32340,3151,0,29189,2933,409,32531,71558
"1422",1992,"Fremont",8242,17136,141231,1019,92,0.0303,3.43,88389,8081,4934,3147,82373,5661,11995,3683,10461,31406,2357,4772,43444,6829,-373,6388,814,96470,82373,14097,6829,20926,4089,0,16837,2702,380,19919,56983
"1423",1992,"Greene",10187,18817,191689,1492,105,0.0303,3.43,112784,15493,6798,8695,100654,7125,9306,5729,13844,33445,3082,5090,56478,9613,-413,8935,1091,128277,100654,27623,9613,37236,4443,0,32793,2741,419,35953,79339
"1424",1992,"Grundy",12081,20553,248296,1628,134,0.0303,3.43,139362,14583,6937,7646,125273,16494,21282,5192,15179,64982,3205,6705,57216,9838,-453,8832,1459,153945,125273,28672,9838,38510,6573,0,31937,3429,498,35864,74380
"1425",1992,"Guthrie",11125,17388,193436,1112,92,0.0303,3.43,90757,8643,6130,2513,85475,12762,9015,3681,10503,47442,2617,4520,42377,6518,-613,6052,1079,99400,85475,13925,6518,20443,2083,0,18360,2922,467,21749,43315
"1426",1992,"Hamilton",16229,18895,306649,1727,112,0.0303,3.43,152662,10423,7975,2448,142990,30270,13030,6132,13735,77345,4308,7851,67664,11291,-207,9518,1980,163085,142990,20095,11291,31386,4639,0,26747,5376,714,32837,75317
"1427",1992,"Hancock",12391,17517,217057,1508,113,0.0303,3.43,119015,12448,8320,4128,114188,14624,12254,6020,13097,53314,4384,3909,59900,10695,-212,9505,1402,131463,114188,17275,10695,27970,2105,0,25865,2033,325,28223,65701
"1428",1992,"Hardin",18937,18337,347257,1587,111,0.0303,3.43,155639,11775,8141,3634,137230,27356,17979,5692,14754,83242,4177,5924,61348,11948,110,9946,1892,167414,137230,30184,11948,42132,6381,0,35751,3101,489,39341,72397
"1429",1992,"Harrison",14752,16869,248853,1060,90,0.0303,3.43,108077,8398,6154,2244,99946,6304,11541,5781,15114,36203,3406,4101,53699,9626,-629,9131,1124,116475,99946,16529,9626,26155,2397,0,23758,1980,294,26032,71874
"1430",1992,"Henry",19641,17491,343539,1176,NA,0.0303,3.43,70491,7524,5681,1843,65763,10385,4852,3383,8347,34268,1956,2938,33902,5198,-162,4484,876,78015,65763,12252,5198,17450,2426,0,15024,1456,222,16702,36223
"1431",1992,"Howard",9977,16228,161909,952,85,0.0303,3.43,81937,9870,6814,3056,80153,11746,6843,4481,10942,47329,3012,3482,39647,5896,-594,5385,1105,91807,80153,11654,5896,17550,903,0,16647,1827,286,18760,34608
"1432",1992,"Humboldt",10586,18698,197941,1662,117,0.0303,3.43,99040,9434,6355,3079,89609,7996,9220,4984,11819,35431,2701,2515,50374,7915,-246,7155,1006,108474,89609,18865,7915,26780,1318,0,25462,1362,201,27025,63609
"1433",1992,"Ida",8290,17599,145896,1443,92,0.0303,3.43,96958,7116,5168,1948,87236,9375,15722,3790,9587,51027,2363,3279,43120,7199,-647,6928,918,104074,87236,16838,7199,24037,1256,0,22781,1616,257,24654,45931
"1434",1992,"Iowa",14750,20811,306965,1230,113,0.0303,3.43,105688,11431,8484,2947,98491,14412,15281,4328,10459,64427,3107,5329,45575,6995,-885,6698,1182,117119,98491,18628,6995,25623,3033,0,22590,3261,471,26322,41261
"1435",1992,"Jackson",20106,15802,317712,1107,108,0.0303,3.43,116350,10969,7125,3844,122758,21481,26452,3021,8335,100573,3389,4136,55944,4630,-1708,5013,1325,127319,122758,4561,4630,9191,695,0,8496,2477,404,11377,15777
"1436",1992,"Jasper",34925,19186,670081,1288,103,0.0303,3.43,150134,12250,8413,3837,133793,19810,17256,6273,15287,85402,3761,5468,65938,9715,-936,9007,1644,162384,133793,28591,9715,38306,4768,0,33538,3238,493,37269,64732
"1437",1992,"Jefferson",16364,17719,289956,903,NA,0.0303,3.43,58545,6644,5033,1611,53689,6536,4945,2700,6379,30584,1817,2300,29012,3697,-433,3491,639,65189,53689,11500,3697,15197,1170,0,14027,1284,194,15505,27961
"1438",1992,"Johnson",99364,19647,1952220,1496,107,0.0303,3.43,110745,11628,7113,4515,106264,21927,12254,4380,10869,73909,3383,4127,49324,6954,-500,5976,1478,122373,106264,16109,6954,23063,2377,0,20686,2341,382,23409,36836
"1439",1992,"Jones",19818,15302,303260,1206,110,0.0303,3.43,143926,11255,7555,3700,132379,22682,24581,4933,12982,105259,3977,5010,58214,8189,-1154,7715,1628,155181,132379,22802,8189,30991,3873,0,27118,2840,464,30422,38667
"1440",1992,"Keokuk",11592,16690,193466,1131,NA,0.0303,3.43,93520,11258,9865,1393,86704,16132,7899,3876,10307,57557,2818,3406,42266,6494,-399,5685,1208,104778,86704,18074,6494,24568,2558,0,22010,1768,284,24062,35963
"1441",1992,"Kossuth",18098,17473,316225,1594,114,0.0303,3.43,206684,19129,13714,5415,199697,16877,19253,12014,24941,79051,7844,8544,110224,18947,-616,17287,2276,225813,199697,26116,18947,45063,3536,NA,41528,4827,724,47079,127633
"1442",1992,"Lee",39070,17279,675071,1016,NA,0.0303,3.43,82311,6296,3982,2314,75636,11311,9983,3395,8091,48755,2423,3962,36471,4655,-545,4278,922,88607,75636,12971,4655,17626,2763,0,14863,2487,384,17734,33556
"1443",1992,"Linn",174288,21139,3684206,1537,107,0.0303,3.43,112316,11446,7629,3817,108882,12906,10325,5346,13068,56356,3683,5850,57704,8041,-752,7509,1284,123762,108882,14880,8041,22921,3485,0,19436,2886,460,22782,55960
"1444",1992,"Louisa",11479,17044,195644,1402,99,0.0303,3.43,51511,8661,6560,2101,49621,4588,3044,3166,7436,17808,1856,2430,27101,4957,-210,4542,625,60172,49621,10551,4957,15508,1734,0,13774,1307,201,15282,33703
"1445",1992,"Lucas",9132,16540,151041,607,NA,0.0303,3.43,27880,4861,3520,1341,29310,3970,2630,802,2446,18826,1031,1286,17145,1345,-514,1545,314,32741,29310,3431,1345,4776,234,0,4542,608,111,5261,9054
"1446",1992,"Lyon",11914,16390,195270,1437,91,0.0303,3.43,191541,10891,5771,5120,165964,31283,47340,5212,11090,140671,3649,6215,61175,7667,-1521,7329,1859,202432,165964,36468,7667,44135,6824,NA,37312,3859,599,41770,50870
"1447",1992,"Madison",12736,17377,221310,946,90,0.0303,3.43,73376,7584,3999,3585,75195,13828,6955,2827,7427,42623,2061,3995,38102,4302,-541,3891,952,80960,75195,5765,4302,10067,1905,0,8162,2352,348,10862,30753
"1448",1992,"Mahaska",21613,16869,364586,1122,NA,0.0303,3.43,129810,10748,7803,2945,118588,21675,18651,4302,10658,87350,3318,5283,54701,6979,-719,6242,1456,140558,118588,21970,6979,28949,3265,0,25684,3009,463,29156,42460
"1449",1992,"Marion",30276,18231,551949,1039,NA,0.0303,3.43,72314,6435,4578,1857,68425,9107,8493,3402,6857,41089,1912,3829,34825,4044,-545,3813,776,78749,68425,10324,4044,14368,1326,0,13042,1719,300,15061,31225
"1450",1992,"Marshall",37907,19657,745138,1388,105,0.0303,3.43,110595,15843,8226,7617,102759,10752,9598,5444,13887,46581,3545,6033,53500,9189,-513,8468,1234,126438,102759,23679,9189,32868,4423,0,28445,3792,569,32806,64014
"1451",1992,"Mills",13305,20747,276043,1033,83,0.0303,3.43,69554,5975,4229,1746,69683,4753,8938,3506,8945,23050,2057,4682,36802,5849,-307,5449,707,75529,69683,5846,5849,11695,1265,0,10430,3127,438,13995,46504
"1452",1992,"Mitchell",10799,19013,205317,1191,101,0.0303,3.43,118061,9419,6009,3410,106043,18438,18031,4660,9836,75017,3477,5100,46501,7665,-356,6689,1332,127480,106043,21437,7665,29102,2119,0,26983,2830,427,30240,43044
"1453",1992,"Monona",10045,17066,171430,1050,96,0.0303,3.43,107739,10037,7243,2794,100689,7680,14686,5173,14280,43904,3032,4443,51395,8800,-670,8365,1105,117776,100689,17087,8800,25887,1622,0,24265,2258,338,26861,63835
"1454",1992,"Monroe",8209,16567,136002,701,NA,0.0303,3.43,32922,3338,2519,819,35088,4600,5457,844,2224,24494,1076,1419,19468,1140,-666,1483,323,36260,35088,1172,1140,2312,108,0,2204,906,172,3282,8428
"1455",1992,"Montgomery",11916,18259,217578,940,84,0.0303,3.43,68851,8578,4596,3982,63108,5439,8166,2664,7211,27135,2245,5030,32353,4916,-502,4768,650,77429,63108,14321,4916,19237,2188,0,17049,3430,456,20935,41716
"1456",1992,"Muscatine",40831,19786,807888,1452,110,0.0303,3.43,72551,7613,6005,1608,69271,10267,5272,3452,7989,34952,2408,2832,37051,5637,-383,5137,883,80164,69271,10893,5637,16530,2092,0,14438,1747,257,16442,37599
"1457",1992,"O'Brien",15638,17649,275998,1808,100,0.0303,3.43,162043,11512,6689,4823,141532,25934,21810,5823,14361,93330,3870,5058,64676,9214,-648,8045,1817,173555,141532,32023,9214,41237,3965,0,37272,2925,464,40661,68713
"1458",1992,"Osceola",7246,17102,123923,1579,92,0.0303,3.43,104262,8848,4946,3902,93910,12497,14486,4218,9598,57002,3191,3844,46076,5907,-415,5239,1083,113110,93910,19200,5907,25107,3244,0,21863,2260,337,24460,47260
"1459",1992,"Page",16678,17928,299011,840,72,0.0303,3.43,88147,8629,4828,3801,79597,7347,8636,3911,8805,37780,2339,6568,41991,5759,-661,5599,821,96776,79597,17179,5759,22938,2343,0,20595,4514,674,25783,50367
"1460",1992,"Palo Alto",10561,17069,180267,1503,109,0.0303,3.43,117541,12433,8791,3642,103962,10540,14190,5087,12425,49383,3712,3525,54483,9400,-406,8636,1170,129974,103962,26012,9400,35412,3309,0,32103,1926,274,34303,68158
"1461",1992,"Plymouth",23713,18777,445257,1404,88,0.0303,3.43,245849,14150,9108,5042,211664,34648,54173,7357,17612,167006,5718,7359,84797,12258,-1576,11451,2383,259999,211664,48335,12258,60593,3559,NA,57035,4051,677,61763,78843
"1462",1992,"Pocahontas",9312,18015,167754,1641,101,0.0303,3.43,119322,10079,8010,2069,111685,10370,11086,6289,14138,43680,3681,4335,61786,10524,-240,9499,1265,129401,111685,17716,10524,28240,2146,0,26094,2147,318,28559,75642
"1463",1992,"Polk",339643,22802,7744384,1410,103,0.0303,3.43,65838,8277,4646,3631,60881,3950,3531,3918,7991,16096,2019,3768,35704,6004,-82,5429,657,74115,60881,13234,6004,19238,2299,0,16939,2529,352,19820,49742
"1464",1992,"Pottawattamie",83507,17365,1450133,1093,93,0.0303,3.43,194393,13850,9413,4437,173333,13950,31611,8337,20299,90531,5383,8321,85432,13937,-1268,13442,1763,208243,173333,34910,13937,48847,6970,NA,41878,4254,668,46800,103862
"1465",1992,"Poweshiek",18944,18654,353372,1228,110,0.0303,3.43,95156,10781,8362,2419,88739,11826,9568,4035,10115,49362,3165,2583,47447,6699,-642,6270,1071,105937,88739,17198,6699,23897,1153,0,22744,1449,264,24457,45794
"1466",1992,"Ringgold",5414,14762,79922,610,73,0.0303,3.43,41831,6445,5527,918,41817,5778,4001,1462,4328,26356,1715,1365,23168,2078,-808,2394,492,48276,41817,6459,2078,8537,219,0,8318,660,133,9111,15475
"1467",1992,"Sac",12152,17309,210339,1635,105,0.0303,3.43,161520,8745,6028,2717,140709,22347,27603,5759,14112,96089,3882,6008,60998,9724,-804,8848,1680,170265,140709,29556,9724,39280,3245,0,36035,3309,504,39848,65431
"1468",1992,"Scott",154912,19990,3096633,1956,123,0.0303,3.43,100455,11170,5905,5265,91689,11344,9406,4425,11337,50849,3243,4745,47189,7598,-457,6941,1114,111625,91689,19936,7598,27534,4573,0,22961,2979,454,26394,49606
"1469",1992,"Shelby",13318,17338,230911,1156,97,0.0303,3.43,137204,8813,6721,2092,123863,17008,18505,5732,14938,76246,3758,4193,59729,10361,-781,9629,1513,146017,123863,22154,10361,32515,3367,0,29148,2549,387,32084,60958
"1470",1992,"Sioux",30450,17651,537458,1556,100,0.0303,3.43,466562,20700,9281,11419,392566,88476,144652,8242,19612,385204,6531,12663,112390,13456,-3005,12248,4213,487262,392566,94696,13456,108152,10892,NA,97262,7196,1186,105644,81358
"1471",1992,"Story",75130,17698,1329635,1638,107,0.0303,3.43,114792,13340,7084,6256,105130,11246,10711,5019,11913,40570,2917,7314,56010,9869,-281,9013,1137,128132,105130,23002,9869,32871,4389,0,28482,3648,520,32650,74222
"1472",1992,"Tama",17513,17208,301358,1306,114,0.0303,3.43,119669,13768,9950,3818,115923,12113,10730,6050,17480,52142,3948,5428,60174,9801,-683,9033,1451,133437,115923,17514,9801,27315,2299,0,25016,2674,387,28077,67527
"1473",1992,"Taylor",7024,14457,101546,685,75,0.0303,3.43,51232,8219,5691,2528,51801,5660,6392,2323,5703,28234,1801,3056,26866,3317,-666,3413,570,59451,51801,7650,3317,10967,302,0,10665,1658,268,12591,22998
"1474",1992,"Union",12503,16365,204612,732,82,0.0303,3.43,51326,6022,3732,2290,50802,9487,7039,1520,4247,33774,1515,2548,24446,2438,-651,2477,612,57348,50802,6546,2438,8984,386,0,8598,1493,224,10315,17552
"1475",1992,"Van Buren",7700,14997,115474,758,NA,0.0303,3.43,40555,6105,4163,1942,37850,5209,2829,1589,4003,22335,1400,1560,21260,2318,-501,2359,460,46660,37850,8810,2318,11128,1509,0,9619,920,151,10690,18220
"1476",1992,"Wapello",36037,16471,593577,811,NA,0.0303,3.43,41697,5017,3663,1354,37777,4182,4395,1654,4630,20334,1307,1628,19981,3088,-288,2943,433,46714,37777,8937,3088,12025,1050,0,10975,799,131,11905,21363
"1477",1992,"Warren",37150,17963,667340,1035,93,0.0303,3.43,62710,6981,4536,2445,65895,6630,4848,3117,6755,32664,2351,3718,38476,4217,-725,4246,696,69691,65895,3796,4217,8013,839,0,7174,1666,307,9147,30046
"1478",1992,"Washington",20072,18514,371617,1454,109,0.0303,3.43,145037,11129,8607,2522,126639,34231,13645,4481,10544,102029,3396,5871,54471,8100,-280,6474,1906,156166,126639,29527,8100,37627,6969,0,30658,3671,558,34887,43008
"1479",1992,"Wayne",7017,14298,100328,602,NA,0.0303,3.43,37213,7945,5600,2345,41558,4058,2912,1781,5253,20406,1426,1750,24378,2103,-613,2255,461,45158,41558,3600,2103,5703,118,0,5585,592,110,6287,16807
"1480",1992,"Webster",40283,17895,720869,1691,114,0.0303,3.43,135860,15543,8025,7518,122488,15925,7675,6393,15460,42289,3704,5537,67794,11789,-97,10373,1513,151403,122488,28915,11789,40704,4172,0,36532,3463,486,40481,93571
"1481",1992,"Winnebago",11850,18057,213976,1389,108,0.0303,3.43,65709,9840,7161,2679,62170,4694,2665,4171,9090,18654,2919,2579,36052,7797,-118,7141,774,75549,62170,13379,7797,21176,1853,0,19323,1143,199,20665,47055
"1482",1992,"Winneshiek",21051,16990,357652,974,94,0.0303,3.43,143397,12824,7975,4849,127086,25078,14829,4526,9934,119407,3981,6062,62676,6926,-1474,6811,1589,156221,127086,29135,6926,36061,828,0,35233,3326,557,39116,23990
"1483",1992,"Woodbury",100442,18849,1893265,1153,89,0.0303,3.43,163445,17471,11271,6200,161248,18412,46474,6391,17218,98553,3817,6354,62582,11434,-1128,10892,1670,180916,161248,19668,11434,31102,1643,0,29459,3227,518,33204,64892
"1484",1992,"Worth",7930,17243,136740,1341,101,0.0303,3.43,70779,9612,6304,3308,65736,8771,5065,3955,8868,27607,2933,1829,34315,6064,-212,5373,903,80391,65736,14655,6064,20719,1143,0,19576,1005,157,20738,43172
"1485",1992,"Wright",14388,18093,260319,1714,118,0.0303,3.43,106266,14206,8625,5581,99804,7118,5697,5998,14223,26020,3490,4817,58461,10524,-157,9548,1133,120472,99804,20668,10524,31192,2813,0,28379,2494,345,31218,80246
"1486",1993,"Adair",8483,15573,132108,807,85,0.0296,3,83876,11368,8668,2700,76507,9513,9839,3900,9454,46365,2422,3485,37894,-17439,-940,-16549,50,95244,76507,18737,-17439,1298,134,0,1164,1625,263,3052,37511
"1487",1993,"Adams",4634,15118,70057,832,91,0.0296,3,51290,7227,6042,1185,45029,5509,5461,1985,4963,28578,1698,1843,23570,-10206,-671,-9563,NA,58517,45029,13488,-10206,3282,141,0,3141,909,143,4193,22712
"1488",1993,"Allamakee",14231,15448,219845,732,104,0.0296,3,100614,12665,8466,4199,86781,17533,9443,2843,6120,86197,2883,4688,43271,-12699,-1281,-11475,57,113279,86781,26498,-12699,13799,433,0,13366,2240,389,15995,14417
"1489",1993,"Appanoose",13903,14419,200465,560,70,0.0296,3,29198,4927,3965,962,28749,2779,3711,1134,3024,17352,1017,995,16089,-5365,-770,-4614,NA,34125,28749,5376,-5365,NA,NA,0,10,500,99,609,11846
"1490",1993,"Audubon",7038,16257,114416,1275,109,0.0296,3,108470,12460,9885,2575,95917,12954,21321,4174,9691,63967,2715,3661,41401,-17278,-532,-16804,58,120930,95917,25013,-17278,7735,357,0,7378,2017,318,9713,44503
"1491",1993,"Benton",23223,17044,395822,1464,108,0.0296,3,175189,21823,16712,5111,152719,21237,25866,6551,17515,85371,4250,6295,71005,-30907,-889,-30115,97,197012,152719,44293,-30907,13386,1276,NA,12109,3462,528,16099,89818
"1492",1993,"Black Hawk",126976,17973,2282084,1586,118,0.0296,3,119315,17802,13337,4465,109358,14242,10658,6183,14379,58083,3870,7339,52687,-21196,-285,-20987,76,137117,109358,27759,-21196,6563,925,0,5638,4620,676,10934,61232
"1493",1993,"Boone",25133,19273,484388,1590,111,0.0296,3,106334,14852,12129,2723,98992,10200,11780,5660,12147,41061,2835,6011,50359,-22118,-297,-21881,60,121186,98992,22194,-22118,76,NA,0,60,3341,489,3890,65273
"1494",1993,"Bremer",23157,18262,422882,1358,115,0.0296,3,97513,14656,10705,3951,86011,10911,6875,4799,11369,54362,3173,4277,44607,-18080,-519,-17620,59,112169,86011,26158,-18080,8078,540,0,7538,2322,382,10242,43151
"1495",1993,"Buchanan",21091,15817,333590,1382,112,0.0296,3,129731,18725,15555,3170,119442,14587,11621,6567,15662,65178,4318,7176,59511,-25006,-394,-24694,82,148456,119442,29014,-25006,4008,318,0,3690,4579,723,8992,64553
"1496",1993,"Buena Vista",20578,16494,339406,1695,114,0.0296,3,174134,18893,14042,4851,152252,31763,28744,6007,14017,107079,3813,6780,61128,-25050,-271,-24889,110,193027,152252,40775,-25050,15725,2452,NA,13272,3828,558,17658,67055
"1497",1993,"Butler",15578,16495,256964,1447,103,0.0296,3,121382,18831,15674,3157,109967,16296,13534,5917,13386,68781,4001,5118,51715,-20696,-348,-20426,78,140213,109967,30246,-20696,9550,830,0,8720,2910,455,12085,52601
"1498",1993,"Calhoun",11478,15476,177637,1724,NA,0.0296,3,119129,17206,13214,3992,112453,11908,14563,6162,14688,48603,3415,3693,58024,-25594,-305,-25360,71,136335,112453,23882,-25594,-1712,-217,0,-1495,1734,267,506,70526
"1499",1993,"Carroll",21634,18304,395985,1571,122,0.0296,3,217422,17839,11710,6129,185863,32562,57659,5905,13401,156362,4187,5629,66520,-23564,-1091,-22583,110,235261,185863,49398,-23564,25834,4248,NA,21584,3027,519,25130,61060
"1500",1993,"Cass",15090,16984,256285,1081,102,0.0296,3,99732,13458,10429,3029,94723,9261,17451,4651,11294,55012,2964,4219,44883,-18781,-914,-17923,56,113190,94723,18467,-18781,-314,-70,0,-244,2190,337,2283,44720
"1501",1993,"Cedar",17551,18384,322658,1645,124,0.0296,3,140028,21282,17343,3939,126121,16080,13813,6406,15042,66080,4473,6625,63682,-28596,-507,-28172,83,161310,126121,35189,-28596,6593,739,0,5854,3630,547,10031,73948
"1502",1993,"Cerro Gordo",46904,17972,842936,1503,107,0.0296,3,89526,21245,18187,3058,95766,9519,5894,6190,13942,36250,4085,6628,49508,-18687,-78,-18676,67,110771,95766,15005,-18687,-3682,-722,0,-2960,3696,541,1277,53276
"1503",1993,"Cherokee",13912,16888,234944,1451,109,0.0296,3,150511,16617,11721,4896,125631,16154,22966,5334,11960,82725,3777,5182,60258,-25733,-817,-24990,74,167128,125631,41497,-25733,15764,996,NA,14767,2910,441,18118,67786
"1504",1993,"Chickasaw",13238,16260,215247,1106,101,0.0296,3,109219,16896,13315,3581,102228,13248,17301,5168,11891,69923,3551,4986,46083,-17141,-576,-16632,67,126115,102228,23887,-17141,6746,649,0,6097,2417,389,8903,39296
"1505",1993,"Clarke",8549,13564,115962,656,70,0.0296,3,28516,7994,6638,1356,30693,4007,3936,938,2347,21723,1055,1518,16892,-3782,-681,-3121,NA,36510,30693,5817,-3782,2035,65,0,1970,768,110,2848,6793
"1506",1993,"Clay",17700,16922,299512,1564,101,0.0296,3,92921,18381,15648,2733,102572,12858,13672,4993,11021,54825,3120,6614,50294,-14595,-331,-14327,63,111302,102572,8730,-14595,-5865,-1834,0,-4031,3708,537,214,38096
"1507",1993,"Clayton",18909,15916,300948,928,110,0.0296,3,180773,21262,14022,7240,155666,30643,14427,5785,12788,141959,5200,8547,78276,-24359,-1458,-23009,108,202035,155666,46369,-24359,22010,1087,NA,20922,4662,764,26348,38814
"1508",1993,"Clinton",51489,17555,903890,1315,120,0.0296,3,160376,24934,20489,4445,138298,15173,29651,6083,16372,84735,4316,6079,60624,-34036,-966,-33153,83,185310,138298,47012,-34036,12976,1465,NA,11510,3205,552,15267,75641
"1509",1993,"Crawford",16683,15964,266330,1309,99,0.0296,3,142865,16835,13590,3245,131306,15792,23329,5876,15176,76651,3662,5258,62213,-27653,-1058,-26675,80,159700,131306,28394,-27653,741,59,0,682,2832,476,3990,66214
"1510",1993,"Dallas",32262,20844,672479,1296,113,0.0296,3,104941,16295,10915,5380,88484,6029,6854,4811,11175,33438,2636,6858,50121,-24521,-247,-24322,NA,121236,88484,32752,-24521,8231,799,0,7432,4394,674,12500,71503
"1511",1993,"Davis",8398,14792,124220,694,70,0.0296,3,46059,7589,6047,1542,45468,8163,4502,1415,3892,32590,1522,2048,23926,-6628,-960,-5699,NA,53648,45468,8180,-6628,1552,150,0,1402,1227,200,2829,13469
"1512",1993,"Decatur",8163,13190,107669,540,NA,0.0296,3,45967,7817,5919,1898,44986,8431,9933,1064,2701,37803,1321,2175,19361,-4503,-872,-3658,NA,53784,44986,8798,-4503,4295,821,0,3474,1330,197,5001,8164
"1513",1993,"Delaware",18269,16178,295556,1417,116,0.0296,3,207343,21031,16871,4160,177085,39936,24871,5809,13694,171996,5772,6826,80177,-24495,-1050,-23574,129,228374,177085,51289,-24495,26794,1675,NA,25117,3747,668,29532,35347
"1514",1993,"Des Moines",43104,18947,816698,1252,121,0.0296,3,66699,9495,7066,2429,52240,5414,3276,3202,7385,22845,1799,2449,28715,-13762,-267,-13530,NA,76194,52240,23954,-13762,10192,1390,0,8802,1233,209,10244,43854
"1515",1993,"Dickinson",15389,20104,309387,1434,99,0.0296,3,59648,13895,11794,2101,73985,9027,16487,3451,7745,41307,2045,3356,31874,-6392,-492,-5944,NA,73543,73985,-442,-6392,-6834,-2913,0,-3921,1498,225,-2198,18341
"1516",1993,"Dubuque",88261,19043,1680718,1251,112,0.0296,3,210467,15055,9870,5185,173015,40424,28722,4557,10857,189943,4955,7359,76141,-18892,-1894,-17117,119,225522,173015,52507,-18892,33615,1301,NA,32312,3823,691,36826,20524
"1517",1993,"Emmet",11568,15377,177877,1612,108,0.0296,3,47573,20013,18350,1663,66217,5351,10169,3482,7967,29479,2453,2782,34013,-6490,-243,-6286,NA,67586,66217,1369,-6490,-5121,-1141,0,-3980,1604,233,-2143,18094
"1518",1993,"Fayette",22089,14857,328168,1235,114,0.0296,3,173922,22183,17754,4429,150608,23756,17703,6847,17676,115477,5145,8727,70754,-28446,-960,-27592,106,196105,150608,45497,-28446,17051,1334,NA,15716,5299,818,21833,58445
"1519",1993,"Floyd",17060,16690,284734,1311,103,0.0296,3,98121,15988,13480,2508,92297,8645,10531,5583,12150,43067,3468,5929,45991,-18703,-238,-18523,58,114109,92297,21812,-18703,3109,440,0,2669,3701,541,6911,55054
"1520",1993,"Franklin",11252,15312,172296,1583,112,0.0296,3,123737,22754,19420,3334,128306,22523,16022,6410,14690,65478,4199,5986,58476,-21203,77,-21377,97,146491,128306,18185,-21203,-3018,-659,0,-2359,3183,462,1286,58259
"1521",1993,"Fremont",8217,15203,124924,1076,94,0.0296,3,72024,14526,11301,3225,79281,5015,12616,3876,10063,30686,2279,5107,40325,-14042,-372,-13713,NA,86550,79281,7269,-14042,-6773,-3219,0,-3554,2986,432,-136,41338
"1522",1993,"Greene",10280,16388,168470,1502,118,0.0296,3,111887,20914,13006,7908,101304,7070,10200,6046,13907,35023,3046,5346,55689,-25680,-385,-25354,59,132801,101304,31497,-25680,5817,723,0,5094,2820,433,8347,76864
"1523",1993,"Grundy",12071,19279,232721,1660,137,0.0296,3,141025,23264,14857,8407,124354,16208,20630,5563,15410,65642,3268,7343,55932,-24477,-399,-24158,80,164289,124354,39935,-24477,15458,2724,0,12734,3689,542,16965,75383
"1524",1993,"Guthrie",11123,16256,180814,1130,95,0.0296,3,92448,12581,9888,2693,86081,13067,9328,3796,10051,49039,2674,4931,42234,-17096,-531,-16623,58,105029,86081,18948,-17096,1852,209,0,1643,3172,515,5330,43409
"1525",1993,"Hamilton",16188,17902,289793,1758,115,0.0296,3,154992,19441,15723,3718,150195,33201,16232,6446,13997,91312,4371,9163,66785,-22398,77,-22591,116,174433,150195,24238,-22398,1840,281,NA,1558,6376,872,8806,63680
"1526",1993,"Hancock",12170,16076,195641,1571,116,0.0296,3,110664,21389,17003,4386,115016,14910,12493,6422,13462,54753,4399,4466,58864,-21505,-127,-21456,78,132053,115016,17037,-21505,-4468,-919,0,-3549,2401,379,-769,55911
"1527",1993,"Hardin",18822,17631,331860,1616,110,0.0296,3,158402,21543,17326,4217,142818,30252,19926,6054,14496,92594,4172,7050,60868,-23912,NA,-24064,110,179945,142818,37127,-23912,13215,1934,NA,11280,3806,586,15672,65808
"1528",1993,"Harrison",14895,16277,242444,1090,97,0.0296,3,120655,13919,11765,2154,98662,6418,11506,6021,14768,36561,3377,4739,51833,-30031,-603,-29488,60,134574,98662,35912,-30031,5881,512,0,5369,2304,338,8011,84094
"1529",1993,"Henry",19634,17429,342210,1208,100,0.0296,3,74841,12211,10211,2000,66478,9927,4944,3696,8577,34070,2078,3287,33969,-13773,-225,-13596,NA,87052,66478,20574,-13773,6801,961,0,5840,1531,233,7604,40771
"1530",1993,"Howard",10008,14933,149451,976,88,0.0296,3,78393,16290,13284,3006,80497,11161,7404,4805,10946,47334,3113,3921,39147,-13013,-541,-12531,59,94683,80497,14186,-13013,1173,72,0,1101,2053,318,3472,31059
"1531",1993,"Humboldt",10517,17118,180028,1709,121,0.0296,3,89614,16073,12486,3587,87895,7655,9585,5093,11725,34757,2732,2868,48237,-17905,-198,-17761,54,105687,87895,17792,-17905,-113,NA,0,-98,1623,235,1760,54857
"1532",1993,"Ida",8321,16143,134325,1456,NA,0.0296,3,103168,11466,9618,1848,85735,8833,15860,3919,9738,50434,2425,3556,41404,-21334,-594,-20789,NA,114634,85735,28899,-21334,7565,472,0,7093,1752,278,9123,52734
"1533",1993,"Iowa",14857,20363,302526,1258,101,0.0296,3,105627,17181,13989,3192,96680,13724,14737,4531,10602,63806,3164,5442,44480,-18099,-836,-17326,63,122808,96680,26128,-18099,8029,967,0,7062,3119,463,10644,41821
"1534",1993,"Jackson",20165,16167,326012,1107,101,0.0296,3,116210,16121,11916,4205,117397,19867,25449,3223,8475,97446,3467,4317,52599,-16261,-1655,-14675,69,132331,117397,14934,-16261,-1327,-204,0,-1123,2368,400,1645,18764
"1535",1993,"Jasper",35136,19031,668684,1319,102,0.0296,3,156160,19367,14887,4480,130732,18738,16975,6664,15321,83558,3785,6071,63178,-29234,-832,-28489,87,175527,130732,44795,-29234,15561,2136,NA,13424,3515,539,17478,72602
"1536",1993,"Jefferson",16559,17262,285842,927,101,0.0296,3,58376,9548,7957,1591,51839,6229,5098,2750,6111,29722,1832,2366,27453,-10295,-496,-9832,NA,67924,51839,16085,-10295,5790,489,0,5301,1254,196,6751,28654
"1537",1993,"Johnson",100939,20471,2066323,1544,109,0.0296,3,109114,15977,11651,4326,102518,20428,11815,4641,10714,70419,3457,4448,47015,-17116,-574,-16619,77,125091,102518,22573,-17116,5457,561,0,4896,2361,384,7641,38695
"1538",1993,"Jones",19939,14898,297057,1224,109,0.0296,3,146487,18327,14736,3591,130096,21195,25012,5178,12992,102338,4086,5490,56143,-22556,-989,-21652,85,164814,130096,34718,-22556,12162,1669,NA,10492,3045,485,14022,44149
"1539",1993,"Keokuk",11600,15591,180856,1168,106,0.0296,3,97399,16712,15136,1576,87246,15370,8073,4134,10281,56361,3075,3771,42542,-17198,-426,-16837,65,114111,87246,26865,-17198,9667,1105,0,8562,1942,305,10809,41038
"1540",1993,"Kossuth",17983,15225,273800,1650,116,0.0296,3,181361,34843,29249,5594,190452,16582,21167,11596,23959,84264,7399,8693,101056,-36066,-490,-35701,125,216204,190452,25752,-36066,-10314,-1924,NA,-8391,4917,750,-2724,97097
"1541",1993,"Lee",38901,17334,674293,1036,99,0.0296,3,78691,10086,7476,2610,73966,10922,9646,3553,8331,47296,2522,4221,34771,-11607,-498,-11159,50,88777,73966,14811,-11607,3204,527,0,2677,2612,408,5697,31395
"1542",1993,"Linn",176786,21817,3856996,1579,105,0.0296,3,114546,18243,14473,3770,107151,11866,10950,5661,12867,54222,3735,6126,55946,-22836,-726,-22177,67,132789,107151,25638,-22836,2802,425,0,2377,3004,476,5857,60324
"1543",1993,"Louisa",11822,16502,195084,1447,111,0.0296,3,62206,12458,10194,2264,52622,5496,3930,3313,7385,23446,1922,2910,27666,-14811,-176,-14671,NA,74664,52622,22042,-14811,7231,955,0,6276,1593,240,8109,38760
"1544",1993,"Lucas",9181,15998,146876,612,74,0.0296,3,25273,6420,5133,1287,28678,3564,2737,887,2507,18868,1042,1250,16691,-3472,-660,-2829,NA,31693,28678,3015,-3472,-457,-54,0,-403,589,109,295,6405
"1545",1993,"Lyon",11890,15345,182447,1437,98,0.0296,3,196514,17214,11974,5240,168440,31290,47887,5751,11649,143644,3895,6683,61285,-24325,-1456,-22973,104,213728,168440,45288,-24325,20963,3413,NA,17549,3974,628,22151,52870
"1546",1993,"Madison",12808,17309,221697,983,89,0.0296,3,68255,9474,6215,3259,74514,13754,6995,3067,7332,41983,2123,4393,36850,-9840,-623,-9269,52,77729,74514,3215,-9840,-6625,-2895,0,-3730,2554,394,-782,26272
"1547",1993,"Mahaska",21798,16651,362969,1153,112,0.0296,3,138083,15969,12683,3286,120824,22097,20250,4616,10882,92137,3391,5787,53801,-18879,-603,-18358,82,154052,120824,33228,-18879,14349,1778,0,12571,3324,511,16406,45946
"1548",1993,"Marion",30515,18392,561228,1058,88,0.0296,3,72379,9510,7522,1988,67302,8245,8263,3695,7076,39538,2054,4016,33953,-12012,-582,-11471,NA,81889,67302,14587,-12012,2575,274,0,2301,1780,299,4380,32841
"1549",1993,"Marshall",38094,19481,742101,1410,112,0.0296,3,112823,21794,14153,7641,101918,10145,9848,5676,14011,46219,3578,6675,51985,-23634,-480,-23220,66,134617,101918,32699,-23634,9065,1319,0,7746,3916,595,12257,66604
"1550",1993,"Mills",13275,20204,268207,1091,99,0.0296,3,60750,10066,8521,1545,65224,4200,7844,3526,8530,20771,2008,4452,34664,-13903,-295,-13644,NA,70816,65224,5592,-13903,-8311,-2095,0,-6216,2759,397,-3060,39979
"1551",1993,"Mitchell",10947,17336,189775,1250,98,0.0296,3,119073,15251,11729,3522,112241,20687,19946,4945,9975,83123,3645,5985,47058,-15276,-418,-14937,79,134324,112241,22083,-15276,6807,636,0,6171,3518,520,10209,35950
"1552",1993,"Monona",10070,15860,159706,1065,NA,0.0296,3,111790,15878,12751,3127,99048,7555,15201,5625,13980,43206,3008,4780,48899,-26468,-655,-25872,59,127668,99048,28620,-26468,2152,147,0,2005,2334,353,4692,68584
"1553",1993,"Monroe",8175,16405,134108,715,64,0.0296,3,32654,4733,3622,1111,35676,4725,5426,1011,2446,25603,1130,1888,19050,-3795,-707,-3107,NA,37387,35676,1711,-3795,-2084,-226,0,-1858,945,169,-744,7051
"1554",1993,"Montgomery",12053,17585,211949,993,95,0.0296,3,68700,12572,8180,4392,64977,6038,8591,3075,7397,29416,2187,5259,32430,-13788,-474,-13352,NA,81272,64977,16295,-13788,2507,288,0,2219,3445,478,6142,39284
"1555",1993,"Muscatine",41192,19920,820553,1498,111,0.0296,3,71425,12936,10882,2054,68802,9592,5609,3628,8216,33958,2492,3117,36148,-14121,-356,-13812,NA,84361,68802,15559,-14121,1438,188,0,1250,1941,286,3477,37467
"1556",1993,"O'Brien",15635,16334,255388,1807,116,0.0296,3,153362,20243,14824,5419,142673,25473,23483,6331,14333,95604,4002,5560,63491,-21405,-486,-21018,99,173605,142673,30932,-21405,9527,987,NA,8539,3058,480,12077,57758
"1557",1993,"Osceola",7239,15039,108868,1578,105,0.0296,3,96733,17081,12885,4196,97481,14166,16561,4545,9728,64804,3212,4299,44970,-11282,-410,-10936,64,113814,97481,16333,-11282,5051,737,0,4314,2517,377,7208,31929
"1558",1993,"Page",16652,17519,291719,887,80,0.0296,3,82690,11926,7877,4049,77347,6763,8502,4107,8878,36731,2344,6865,39888,-15846,-651,-15238,NA,94616,77347,17269,-15846,1423,140,0,1283,4291,643,6217,45959
"1559",1993,"Palo Alto",10506,14432,151625,1540,107,0.0296,3,102449,21209,17629,3580,108386,12227,15739,5438,12634,56345,3765,4549,54034,-17766,-299,-17535,68,123658,108386,15272,-17766,-2494,-539,0,-1955,2449,358,852,46104
"1560",1993,"Plymouth",23944,18710,447996,1415,100,0.0296,3,270119,22704,16551,6153,210556,34290,54123,7831,17903,167035,5779,8066,82564,-42634,-1404,-41361,131,292823,210556,82267,-42634,39633,2491,NA,37140,4317,707,42164,103084
"1561",1993,"Pocahontas",9167,14925,136815,1684,112,0.0296,3,108525,18895,15894,3001,109807,10421,11133,6563,14235,43847,3671,4560,59224,-23524,-185,-23408,69,127420,109807,17613,-23524,-5911,-1062,0,-4849,2200,330,-2319,64678
"1562",1993,"Polk",345143,23366,8064557,1427,106,0.0296,3,65037,12760,9074,3686,59653,3620,3536,4126,8058,15207,2036,4128,34149,-16020,-162,-15893,NA,77797,59653,18144,-16020,2124,271,0,1853,2674,381,4908,49830
"1563",1993,"Pottawattamie",83643,17425,1457451,1138,102,0.0296,3,196965,23011,18046,4965,173862,13328,32378,8880,20598,88669,5326,8684,84668,-38131,-1216,-37010,95,219976,173862,46114,-38131,7983,1249,NA,6733,4397,691,11821,108296
"1564",1993,"Poweshiek",18884,18471,348800,1258,105,0.0296,3,100044,15731,13173,2558,88471,11325,9464,4323,10147,49961,3337,3361,46514,-19016,-673,-18400,57,115775,88471,27304,-19016,8288,630,0,7658,1991,336,9985,50083
"1565",1993,"Ringgold",5405,13547,73221,626,77,0.0296,3,38911,9567,7785,1782,43192,6551,4154,1540,4239,28304,1775,1903,23030,-5548,-811,-4766,NA,48478,43192,5286,-5548,-262,NA,0,-248,950,161,863,10607
"1566",1993,"Sac",12036,16108,193874,1639,NA,0.0296,3,174931,14777,11628,3149,147880,24338,28793,6195,14631,102442,4018,7230,62675,-26936,-757,-26273,94,189708,147880,41828,-26936,14892,1267,NA,13624,3994,597,18215,72489
"1567",1993,"Scott",155375,20411,3171330,2017,133,0.0296,3,111257,15979,11059,4920,89937,10613,9452,4707,11439,48345,3300,4882,45544,-23787,-363,-23483,59,127236,89937,37299,-23787,13512,2323,0,11189,2989,457,14635,62912
"1568",1993,"Shelby",13295,16317,216932,1186,100,0.0296,3,144633,15351,12957,2394,121243,16017,18730,6092,15014,74178,3773,4509,57108,-29414,-706,-28788,80,159984,121243,38741,-29414,9327,951,0,8376,2570,399,11345,70455
"1569",1993,"Sioux",30965,17294,535518,1562,111,0.0296,3,502282,30780,18715,12065,408978,92049,151325,9401,20191,403096,6957,14980,114075,-45158,-3073,-42327,242,533062,408978,124084,-45158,78926,8256,NA,70668,8381,1355,80404,99186
"1570",1993,"Story",76008,18029,1370386,1654,114,0.0296,3,110199,21522,14929,6593,105978,10835,11029,5521,12703,40939,3041,8014,54835,-23334,-291,-23106,63,131721,105978,25743,-23334,2409,366,0,2043,3909,577,6529,69260
"1571",1993,"Tama",17728,16854,298792,1330,115,0.0296,3,127456,21698,17474,4224,114611,11525,10769,6307,17218,51607,3997,6196,58599,-27581,-704,-26954,77,149154,114611,34543,-27581,6962,586,0,6376,2948,431,9755,75849
"1572",1993,"Taylor",7024,13442,94419,712,77,0.0296,3,52057,10294,7942,2352,51438,6556,6610,2355,5527,29454,1837,3259,25294,-9432,-622,-8843,NA,62351,51438,10913,-9432,1481,NA,0,1442,1714,270,3426,22603
"1573",1993,"Union",12482,16160,201708,751,71,0.0296,3,46282,7939,5891,2048,47459,8219,6725,1650,4189,32190,1452,2522,22702,-6539,-994,-5576,NA,54221,47459,6762,-6539,223,NA,0,212,1396,214,1822,14092
"1574",1993,"Van Buren",7725,14166,109433,773,92,0.0296,3,38406,8050,6311,1739,38232,5181,2806,1670,4121,22184,1401,1882,21171,-6283,-552,-5756,NA,46456,38232,8224,-6283,1941,277,0,1664,1141,178,2983,16222
"1575",1993,"Wapello",36272,16364,593551,833,117,0.0296,3,40060,8189,6756,1433,38426,3908,4306,1956,4837,19950,1396,1856,20167,-7876,-368,-7532,NA,48249,38426,9823,-7876,1947,181,0,1766,912,145,2823,20110
"1576",1993,"Warren",37769,18346,692901,1050,88,0.0296,3,54063,10889,8247,2642,63555,6117,4682,3225,6586,31219,2388,3845,36712,-9559,-735,-8860,NA,64952,63555,1397,-9559,-8162,-1961,0,-6201,1684,298,-4219,22844
"1577",1993,"Washington",20098,18586,373548,1501,118,0.0296,3,156380,17539,14447,3092,129146,33498,15405,4892,11037,107248,3614,6629,54071,-19715,-191,-19628,104,173919,129146,44773,-19715,25058,4935,NA,20122,4047,611,24780,49132
"1578",1993,"Wayne",7043,13308,93728,607,68,0.0296,3,34025,9767,7621,2146,40358,3807,3131,1857,5035,19901,1450,1948,23130,-5823,-675,-5172,NA,43792,40358,3434,-5823,-2389,-141,0,-2248,625,111,-1512,14124
"1579",1993,"Webster",40137,17491,702035,1721,111,0.0296,3,129586,23255,16051,7204,125982,15691,8426,6916,16084,44928,3805,6382,68678,-28200,NA,-28262,83,152841,125982,26859,-28200,-1341,-347,0,-994,3837,549,3392,84658
"1580",1993,"Winnebago",11757,16830,197866,1446,112,0.0296,3,55163,16016,13411,2605,62548,4342,2789,4425,9581,18157,2950,2678,35783,-14007,-80,-13969,NA,71179,62548,8631,-14007,-5376,-1103,0,-4273,1214,203,-2856,37006
"1581",1993,"Winneshiek",21113,16566,349751,976,98,0.0296,3,143386,18674,13424,5250,125488,23661,14505,4866,10336,116587,4208,6528,61384,-20491,-1472,-19104,85,162060,125488,36572,-20491,16081,434,0,15647,3462,581,19690,26799
"1582",1993,"Woodbury",101640,18760,1906770,1168,NA,0.0296,3,170159,24797,18285,6512,158905,17292,43858,6965,17543,94306,3958,6932,62357,-33268,-1102,-32256,90,194956,158905,36051,-33268,2783,167,NA,2615,3505,554,6674,75853
"1583",1993,"Worth",8031,14993,120406,1402,102,0.0296,3,62026,16112,12791,3321,64787,8283,4758,4179,9069,26234,2946,2010,33542,-12165,-158,-12055,NA,78138,64787,13351,-12165,1186,82,0,1104,1107,175,2386,35792
"1584",1993,"Wright",14348,16532,237206,1763,117,0.0296,3,109040,23481,17398,6083,111344,12146,7957,6258,14401,39259,3592,6515,60475,-23475,-59,-23490,74,132521,111344,21177,-23475,-2298,-499,0,-1799,3982,532,2715,69781
"1585",1994,"Adair",8380,18480,154860,850,91,0.0261,4.25,70836,8282,5241,3041,78057,10314,8608,3657,9986,39553,2236,3524,39732,21566,-586,21205,947,79118,78057,1061,21566,22627,2808,0,19819,1673,285,21777,31283
"1586",1994,"Adams",4616,17962,82912,884,78,0.0261,4.25,42251,5105,3923,1182,46310,5607,4905,2052,5420,24460,1627,1955,24744,11935,-446,11851,530,47356,46310,1046,11935,12981,592,0,12389,983,159,13531,17791
"1587",1994,"Allamakee",14248,16828,239763,813,97,0.0261,4.25,88643,10343,5814,4529,85562,17099,7528,2674,6363,75441,2703,4558,44637,11472,-859,11300,1031,98986,85562,13424,11472,24896,833,0,24063,2127,390,26580,13202
"1588",1994,"Appanoose",13726,15849,217544,568,67,0.0261,4.25,24854,4346,3433,913,27856,2671,3040,1059,3013,14426,927,909,16237,5928,-377,5972,333,29200,27856,1344,5928,7272,300,0,6972,459,90,7521,10428
"1589",1994,"Audubon",6992,18939,132419,1378,101,0.0261,4.25,90434,7875,5393,2482,97124,14190,18213,4322,10731,56917,2575,3722,43371,21098,-614,20561,1151,98309,97124,1185,21098,22283,1310,0,20973,1968,323,23264,33517
"1590",1994,"Benton",23552,18748,441563,1566,113,0.0261,4.25,132821,13416,8623,4793,151786,20187,20489,6652,19158,69601,4138,6579,74583,36147,-721,35093,1775,146237,151786,-5549,36147,30598,3465,0,27133,3332,534,30999,63220
"1591",1994,"Black Hawk",127150,19161,2436328,1654,116,0.0261,4.25,104069,12593,8042,4551,110327,15117,9361,5866,15108,51326,3615,7003,54257,29738,-508,28812,1434,116662,110327,6335,29738,36073,5643,0,30430,4252,647,35329,52743
"1592",1994,"Boone",25161,21405,538566,1727,110,0.0261,4.25,91441,8902,6146,2756,101657,10499,9888,5719,13416,35406,2706,6067,53362,32236,-372,31451,1157,100343,101657,-1314,32236,30922,7465,0,23457,3346,496,27299,56035
"1593",1994,"Bremer",23098,19884,459286,1451,117,0.0261,4.25,84212,10159,5977,4182,86935,10845,6538,4584,12039,48941,2981,4163,45785,22601,-450,21959,1092,94371,86935,7436,22601,30037,2224,0,27813,2154,364,30331,35271
"1594",1994,"Buchanan",21230,17774,377336,1460,110,0.0261,4.25,109363,10853,7731,3122,121800,15503,10502,6320,16613,58215,4083,6871,61908,31197,-650,30310,1537,120216,121800,-1584,31197,29613,2700,0,26913,4182,686,31781,51148
"1595",1994,"Buena Vista",20497,18688,383056,1760,107,0.0261,4.25,157529,13827,8238,5589,155937,34596,26630,5921,15134,99959,3753,6591,63312,36716,-707,35273,2150,171356,155937,15419,36716,52135,9071,NA,43063,3702,562,47327,57570
"1596",1994,"Butler",15578,18569,289267,1524,109,0.0261,4.25,104047,12439,9436,3003,111603,16299,12378,5841,14731,60085,3665,4894,53795,27465,-627,26642,1450,116486,111603,4883,27465,32348,3032,0,29316,2631,436,32383,43962
"1597",1994,"Calhoun",11630,19161,222845,1758,112,0.0261,4.25,109677,10333,6139,4194,116310,12641,13350,5989,15905,44395,3348,4101,60976,39649,-480,38766,1363,120010,116310,3700,39649,43349,3258,0,40091,1751,279,42121,65282
"1598",1994,"Carroll",21525,19877,427855,1579,112,0.0261,4.25,190508,11603,4995,6608,186183,34501,49254,6015,14915,137042,4087,5680,71731,33821,-1369,33045,2145,202111,186183,15928,33821,49749,8677,NA,41071,2990,552,44613,53466
"1599",1994,"Cass",15168,18777,284810,1169,95,0.0261,4.25,83727,8485,5633,2852,93224,9332,14998,4441,11644,45638,2706,4160,45943,24882,-598,24469,1011,92212,93224,-1012,24882,23870,2608,0,21262,1981,324,23567,38089
"1600",1994,"Cedar",17566,20656,362851,1738,125,0.0261,4.25,110118,13010,8626,4384,125618,15596,11807,6232,15813,55586,4116,6554,65500,32317,-667,31491,1493,123128,125618,-2490,32317,29827,3598,0,26229,3351,524,30104,54532
"1601",1994,"Cerro Gordo",46945,19815,930209,1587,108,0.0261,4.25,88546,16232,12925,3307,99381,10286,5568,6149,14939,33832,3846,6443,52150,30877,-329,29929,1277,104778,99381,5397,30877,36274,3626,0,32648,3458,529,36635,54714
"1602",1994,"Cherokee",13882,18653,258938,1532,106,0.0261,4.25,119961,9480,4568,4912,127126,17176,19852,5210,13033,72589,3534,5249,63072,29559,-858,29009,1408,129441,127126,2315,29559,31874,2453,0,29421,2784,443,32648,47372
"1603",1994,"Chickasaw",13287,18646,247744,1183,89,0.0261,4.25,98532,12030,8129,3901,103605,14083,15255,5042,12763,63119,3422,4977,48063,23612,-591,22926,1277,110562,103605,6957,23612,30569,3223,0,27346,2351,408,30105,35413
"1604",1994,"Clarke",8429,15190,128033,664,69,0.0261,4.25,30126,6937,5457,1480,33169,4945,3589,971,2490,20512,985,2056,18133,6505,-420,6514,411,37063,33169,3894,6505,10399,315,0,10084,884,132,11100,9614
"1605",1994,"Clay",17696,20085,355417,1638,105,0.0261,4.25,97298,16650,13688,2962,102895,13261,11745,4918,11858,48764,2934,6164,52015,30889,-372,30075,1186,113948,102895,11053,30889,41942,7023,0,34919,3296,499,38714,48534
"1606",1994,"Clayton",18886,17205,324936,1077,108,0.0261,4.25,157873,16895,9642,7253,159678,31722,12728,5810,13737,128473,5027,8446,82208,21500,-1349,20816,2033,174768,159678,15090,21500,36590,2145,NA,34444,4469,771,39684,29400
"1607",1994,"Clinton",51320,18780,963764,1374,116,0.0261,4.25,126523,14284,9679,4605,136878,15452,24545,6202,17653,70755,4112,5937,62977,35765,-772,34978,1559,140807,136878,3929,35765,39694,5295,0,34399,2884,529,37812,55768
"1608",1994,"Crawford",16715,18149,303364,1378,100,0.0261,4.25,116983,10249,6880,3369,132664,15984,20450,5865,16582,65323,3516,5351,64916,33928,-901,33330,1499,127232,132664,-5432,33928,28496,2461,0,26035,2725,471,29231,51660
"1609",1994,"Dallas",33036,22576,745812,1419,107,0.0261,4.25,83432,10521,4626,5895,92627,6665,6333,4744,11895,31647,2558,7234,53198,28763,-251,28078,936,93953,92627,1326,28763,30089,3399,0,26690,4502,707,31899,51785
"1610",1994,"Davis",8452,16060,135742,751,67,0.0261,4.25,42356,6868,5244,1624,48831,9827,4339,1369,4212,30993,1551,2168,25365,7242,-477,7089,630,49224,48831,393,7242,7635,1117,0,6518,1289,207,8014,11363
"1611",1994,"Decatur",8290,14253,118161,538,65,0.0261,4.25,43889,7317,5451,1866,46659,9733,8279,1068,2943,34057,1277,2074,21285,6609,-528,6581,556,51206,46659,4547,6609,11156,2410,0,8746,1200,186,10132,9832
"1612",1994,"Delaware",18322,18037,330481,1531,111,0.0261,4.25,186041,11474,6870,4604,178415,40342,21656,5612,14884,154003,5490,6571,83860,29584,-1614,28817,2381,197515,178415,19100,29584,48684,3533,NA,45150,3368,655,49173,32038
"1613",1994,"Des Moines",43112,19985,861595,1345,107,0.0261,4.25,52100,6139,3596,2543,55312,6051,3591,3202,8141,21753,1820,2396,30111,16188,-298,15791,695,58239,55312,2927,16188,19115,2863,0,16252,1114,207,17573,30347
"1614",1994,"Dickinson",15414,22507,346929,1489,96,0.0261,4.25,64577,10841,8533,2308,73278,9325,13919,3349,8244,34506,1924,3123,33394,17843,-306,17329,820,75418,73278,2140,17843,19983,3715,0,16268,1237,193,17698,30071
"1615",1994,"Dubuque",88654,20379,1806641,1354,120,0.0261,4.25,185982,13337,7822,5515,171563,40211,24689,4435,11402,167292,4804,7293,78729,18118,-1710,17652,2176,199319,171563,27756,18118,45874,1745,NA,44128,3577,688,48393,18690
"1616",1994,"Emmet",11501,18299,210458,1720,108,0.0261,4.25,64695,12057,10162,1895,69562,6590,9468,3401,8621,28265,2241,2736,36505,22560,-314,22108,766,76752,69562,7190,22560,29750,2899,0,26851,1519,230,28600,36430
"1617",1994,"Fayette",22129,17144,379378,1330,109,0.0261,4.25,152427,16074,11276,4798,153878,24579,16406,6706,18966,105651,4990,8368,73863,33004,-1038,32053,1989,168501,153878,14623,33004,47627,4401,NA,43225,4948,802,48975,46776
"1618",1994,"Floyd",17062,18110,308993,1387,107,0.0261,4.25,83964,11459,8911,2548,96378,8538,8815,5563,13627,37412,3333,6549,49953,25728,-388,25003,1113,95423,96378,-955,25728,24773,3850,0,20923,3798,580,25301,46552
"1619",1994,"Franklin",11045,19386,214123,1672,112,0.0261,4.25,122153,15754,12100,3654,138576,28964,15419,6299,16318,65184,3926,6095,61555,34838,-440,33217,2061,137907,138576,-669,34838,34169,3472,0,30697,3020,464,34181,56969
"1620",1994,"Fremont",8259,18502,152812,1117,92,0.0261,4.25,67638,8761,5567,3194,81065,4938,10821,4012,11069,25274,2190,5195,42840,23644,-262,23105,801,76399,81065,-4666,23644,18978,4270,0,14708,2883,435,18026,42364
"1621",1994,"Greene",10255,19639,201395,1536,108,0.0261,4.25,93601,12438,5534,6904,104646,7450,9261,5923,15016,31546,2811,5116,59069,35667,-415,34963,1119,106039,104646,1393,35667,37060,5118,0,31942,2557,408,34907,62055
"1622",1994,"Grundy",12152,21604,262536,1766,131,0.0261,4.25,114935,17453,8602,8851,124909,16910,16496,5525,16799,57209,3116,7219,58844,32829,-489,31802,1516,132388,124909,7479,32829,40308,7909,0,32399,3481,533,36413,57726
"1623",1994,"Guthrie",11139,18601,207200,1244,101,0.0261,4.25,78586,8875,6095,2780,88961,14216,8152,3639,10360,44458,2555,4793,45246,21931,-473,21288,1116,87461,88961,-1500,21931,20431,2788,0,17643,3040,525,21208,34128
"1624",1994,"Hamilton",16233,21587,350427,1892,115,0.0261,4.25,156683,13719,8922,4797,161291,38473,16805,6294,15310,93793,4146,9359,70904,38225,-686,36555,2356,170402,161291,9111,38225,47336,7335,NA,40000,6511,927,47438,62890
"1625",1994,"Hancock",12073,19535,235844,1673,115,0.0261,4.25,101525,15318,10831,4487,118985,16154,10708,6354,14836,49462,4124,4569,62240,32391,-457,31344,1504,116843,118985,-2142,32391,30249,3549,0,26700,2469,403,29572,52063
"1626",1994,"Hardin",18941,19923,377362,1716,115,0.0261,4.25,149040,14922,10289,4633,151449,35300,18476,5974,15331,90030,3894,7535,64939,35351,-736,33867,2220,163962,151449,12513,35351,47864,6889,NA,40974,4023,635,45632,59010
"1627",1994,"Harrison",14993,18285,274149,1196,98,0.0261,4.25,86820,7372,5370,2002,99663,6943,9418,5829,15537,31409,3127,4943,53866,31469,-440,30775,1134,94192,99663,-5471,31469,25998,2476,0,23522,2327,344,26193,55411
"1628",1994,"Henry",19841,18657,370177,1295,107,0.0261,4.25,61694,8332,6245,2087,69519,10052,4322,3733,9450,30132,2064,3329,36569,18328,-315,17740,903,70026,69519,507,18328,18835,2976,0,15859,1422,227,17508,31562
"1629",1994,"Howard",9944,18138,180362,1055,81,0.0261,4.25,73289,11827,8963,2864,83213,11221,6878,4774,11775,42162,3011,3978,41576,19732,-491,19118,1105,85116,83213,1903,19732,21635,1603,0,20032,2025,324,22381,31127
"1630",1994,"Humboldt",10492,20474,214811,1820,113,0.0261,4.25,79551,9888,5938,3950,88680,7762,8340,4841,12514,29704,2583,2905,49735,28377,-295,27679,993,89439,88680,759,28377,29136,2311,0,26825,1671,247,28743,49847
"1631",1994,"Ida",8333,18618,155140,1547,100,0.0261,4.25,79698,5502,3807,1695,85023,8794,13231,3766,10619,42752,2326,3481,42806,23583,-549,23221,911,85200,85023,177,23583,23760,1889,0,21871,1674,278,23823,36946
"1632",1994,"Iowa",14927,22222,331708,1365,106,0.0261,4.25,90154,12702,9380,3322,96224,13834,11773,4406,11540,54451,3012,4937,46722,22766,-697,22287,1176,102856,96224,6632,22766,29398,3836,0,25562,2595,406,28563,35703
"1633",1994,"Jackson",20262,17115,346782,1176,102,0.0261,4.25,98438,12273,7860,4413,112974,19352,20585,3189,9252,82026,3316,4047,53233,14884,-1094,14724,1254,110711,112974,-2263,14884,12621,887,0,11734,1997,373,14104,16412
"1634",1994,"Jasper",35342,20948,740353,1420,116,0.0261,4.25,125483,12643,7698,4945,130534,18743,13908,6568,16508,70782,3562,6066,65179,33442,-867,32691,1618,138126,130534,7592,33442,41034,6671,0,34363,3357,539,38259,54701
"1635",1994,"Jefferson",16563,19333,320208,997,103,0.0261,4.25,49825,7600,6077,1523,51538,6286,4450,2607,6306,25148,1727,2192,27970,14759,-318,14468,609,57425,51538,5887,14759,20646,2014,0,18632,1076,179,19887,24677
"1636",1994,"Johnson",103045,21740,2240180,1697,108,0.0261,4.25,93086,12201,8188,4013,101621,20074,9715,4564,11369,59333,3302,4344,48253,22211,-659,21468,1402,105287,101621,3666,22211,25877,2846,0,23031,2109,359,25499,33753
"1637",1994,"Jones",20095,16306,327674,1305,108,0.0261,4.25,122628,11465,8088,3377,128819,20902,21253,5049,13982,86240,3928,5411,58294,25528,-988,24948,1568,134093,128819,5274,25528,30802,4896,0,25906,2887,472,29265,36388
"1638",1994,"Keokuk",11490,17738,203814,1226,105,0.0261,4.25,80957,13523,11821,1702,90448,15504,6945,4089,11030,48280,3131,3761,45988,22159,-610,21557,1212,94480,90448,4032,22159,26191,3527,0,22664,1881,305,24850,32677
"1639",1994,"Kossuth",17950,19377,347821,1792,114,0.0261,4.25,178121,27141,21549,5592,203388,19018,19438,11500,27284,78176,7222,8771,110155,60126,-834,58599,2361,205262,203388,1874,60126,62000,5720,NA,56279,4410,714,61403,99945
"1640",1994,"Lee",38965,18816,733159,1128,87,0.0261,4.25,68339,7942,5134,2808,73891,11183,7858,3452,9195,40203,2455,4053,35695,16566,-494,16116,944,76281,73891,2390,16566,18956,3456,0,15500,2419,395,18314,28136
"1641",1994,"Linn",179064,23105,4137304,1678,113,0.0261,4.25,94601,11487,7878,3609,108182,11478,9722,5564,13638,45281,3542,5845,58393,28119,-558,27452,1225,106088,108182,-2094,28119,26025,4249,0,21776,2765,459,25000,49320
"1642",1994,"Louisa",11850,18075,214191,1506,107,0.0261,4.25,56049,8405,6058,2347,61512,7404,3975,3486,8535,25304,2012,3353,32747,18106,-248,17627,727,64454,61512,2942,18106,21048,3541,0,17507,1672,260,19439,30745
"1643",1994,"Lucas",9184,17981,165135,608,69,0.0261,4.25,23575,5818,4621,1197,28297,3277,2402,877,2676,16145,960,1096,17009,4821,-350,4854,317,29393,28297,1096,4821,5917,360,0,5557,508,103,6168,7430
"1644",1994,"Lyon",11811,17814,210407,1482,99,0.0261,4.25,173783,10513,5326,5187,168605,33256,40124,5857,13077,126113,3886,6437,65968,32136,-1258,31371,2023,184296,168605,15691,32136,47827,8703,NA,39123,3615,611,43349,47670
"1645",1994,"Madison",12949,19019,246278,1013,92,0.0261,4.25,61916,7843,4997,2846,76203,14534,6060,3079,7791,36681,2045,4325,38369,15006,-439,14456,989,69759,76203,-6444,15006,8562,1798,0,6764,2436,405,9605,25235
"1646",1994,"Mahaska",21908,18273,400318,1222,93,0.0261,4.25,123716,11414,7909,3505,124689,23939,18357,4590,11924,84427,3240,5708,56931,25763,-861,25042,1582,135130,124689,10441,25763,36204,5242,0,30962,3227,518,34707,39289
"1647",1994,"Marion",30805,19929,613917,1108,93,0.0261,4.25,62690,7547,5494,2053,67681,7824,6797,3714,7827,33221,2060,3830,35629,16678,-449,16365,762,70237,67681,2556,16678,19234,2471,0,16763,1642,281,18686,29469
"1648",1994,"Marshall",38526,20998,808987,1505,109,0.0261,4.25,90630,15389,7972,7417,103670,10120,8471,5500,15187,39866,3376,6643,54373,28408,-476,27659,1225,106019,103670,2349,28408,30757,5125,0,25632,3560,566,29758,50764
"1649",1994,"Mills",13446,22467,302092,1174,100,0.0261,4.25,51046,5758,4450,1308,62145,3861,5565,3297,8764,15695,1827,3683,35148,20188,-200,19754,634,56804,62145,-5341,20188,14847,1904,0,12943,2061,314,15318,35351
"1650",1994,"Mitchell",10974,20055,220086,1319,107,0.0261,4.25,115875,13864,10351,3513,119488,24431,18353,4870,10861,79766,3574,6283,51116,24015,-771,23173,1613,129739,119488,10251,24015,34266,4023,0,30243,3748,566,34557,36109
"1651",1994,"Monona",10092,18428,185973,1162,98,0.0261,4.25,84204,9674,6332,3342,98772,7891,12921,5660,14737,36047,2787,4685,50091,29403,-460,28748,1115,93878,98772,-4894,29403,24509,2008,0,22501,2125,336,24962,48157
"1652",1994,"Monroe",8184,18030,147559,758,69,0.0261,4.25,31265,5132,3779,1353,36176,5042,4469,1073,2779,22899,1082,2178,19553,5638,-401,5666,373,36397,36176,221,5638,5859,319,0,5540,885,162,6587,8366
"1653",1994,"Montgomery",11992,19376,232355,1034,91,0.0261,4.25,59652,8591,3955,4636,67746,7066,7507,3249,8138,27520,1985,4875,34926,17380,-333,16967,746,68243,67746,497,17380,17877,2225,0,15652,3017,441,19110,32132
"1654",1994,"Muscatine",41246,21025,867177,1603,108,0.0261,4.25,64001,9061,6648,2413,70548,9458,5079,3540,9059,29170,2411,3044,37957,19854,-339,19317,876,73062,70548,2514,19854,22368,3200,0,19168,1884,289,21341,34831
"1655",1994,"O'Brien",15646,19121,299172,1868,106,0.0261,4.25,140443,15112,9305,5807,145899,26564,21127,6370,15385,85253,3873,5516,67064,33493,-851,32468,1876,155555,145899,9656,33493,43149,4914,NA,38234,2825,460,41519,55190
"1656",1994,"Osceola",7217,19292,139232,1627,104,0.0261,4.25,102544,13478,9142,4336,102231,16872,15678,4536,10588,63419,3022,4297,47238,23132,-556,22399,1289,116022,102231,13791,23132,36923,6216,0,30707,2455,380,33542,39125
"1657",1994,"Page",16784,19068,320045,919,82,0.0261,4.25,65380,8952,4798,4154,76485,6551,6928,4005,9617,30544,2195,6395,40794,18419,-485,18105,799,74332,76485,-2153,18419,16266,1643,0,14623,3554,552,18729,34836
"1658",1994,"Palo Alto",10511,18308,192431,1655,100,0.0261,4.25,106126,16887,13479,3408,114642,14825,14309,5390,13793,55187,3571,5130,57624,31003,-493,30115,1381,123013,114642,8371,31003,39374,4276,0,35098,2641,403,38142,50939
"1659",1994,"Plymouth",24256,19884,482295,1576,99,0.0261,4.25,210868,13117,6109,7008,208095,36048,44747,7732,19536,143866,5468,8034,86530,43694,-1614,42828,2480,223985,208095,15890,43694,59584,4505,NA,55078,4079,689,59846,67002
"1660",1994,"Pocahontas",9140,19957,182407,1781,109,0.0261,4.25,101005,11107,7322,3785,111124,11127,9374,6365,15402,38497,3420,4312,61124,38340,-357,37387,1310,112112,111124,988,38340,39328,3542,0,35786,1982,312,38080,62508
"1661",1994,"Polk",349349,24597,8593021,1495,116,0.0261,4.25,54825,7352,3733,3619,60310,3487,2957,4034,8731,12372,1919,4014,35168,21771,-150,21271,650,62177,60310,1867,21771,23638,3426,0,20212,2472,365,23049,42453
"1662",1994,"Pottawattamie",83540,18987,1586198,1236,101,0.0261,4.25,156785,13212,7904,5308,175170,13487,27170,8777,22438,73475,4919,8138,90241,46808,-846,45875,1779,169997,175170,-5173,46808,41635,7736,NA,33898,4013,660,38571,83310
"1663",1994,"Poweshiek",18999,20416,387880,1371,111,0.0261,4.25,83471,10761,8149,2612,90740,11487,7808,4295,10943,43810,3289,3850,49068,23499,-592,23008,1083,94232,90740,3492,23499,26991,2978,0,24013,2288,389,26690,39661
"1664",1994,"Ringgold",5378,16564,89079,633,80,0.0261,4.25,39403,9488,6947,2541,45966,7803,3545,1505,4472,25918,1719,2310,24612,9263,-599,9286,576,48891,45966,2925,9263,12188,264,0,11924,1126,184,13234,13485
"1665",1994,"Sac",12090,18676,225797,1648,108,0.0261,4.25,150033,7884,4429,3455,152071,27123,24812,6002,15802,94079,3769,7482,67081,35430,-925,34502,1853,157917,152071,5846,35430,41276,3958,NA,37317,4164,639,42120,55954
"1666",1994,"Scott",155740,21391,3331383,2119,123,0.0261,4.25,83938,8376,3941,4435,90544,10481,8009,4645,12401,40321,3140,4542,47326,24280,-452,23633,1099,92314,90544,1770,24280,26050,5044,0,21006,2637,417,24060,43617
"1667",1994,"Shelby",13278,18486,245454,1298,96,0.0261,4.25,113748,7697,5093,2604,120620,15939,15770,6007,16216,62254,3541,4356,58791,33267,-691,32470,1488,121445,120620,825,33267,34092,3923,0,30169,2280,375,32824,51494
"1668",1994,"Sioux",31352,18484,579515,1685,113,0.0261,4.25,437215,18588,6302,12286,406548,99471,131340,9664,21868,362793,6791,15531,121883,49815,-2772,47831,4756,455803,406548,49255,49815,99070,11618,NA,87450,8536,1420,97406,74422
"1669",1994,"Story",75899,19536,1482789,1792,115,0.0261,4.25,95671,15115,8417,6698,109407,11065,9651,5608,14442,36426,2966,7903,57772,33956,-356,33094,1218,110786,109407,1379,33956,35335,6391,0,28944,3675,577,33196,59245
"1670",1994,"Tama",17906,19027,340698,1436,120,0.0261,4.25,100185,15169,10695,4474,116623,11609,9074,6111,18255,44333,3786,6366,61422,32618,-554,31747,1425,115354,116623,-1269,32618,31349,2875,0,28474,2843,430,31747,55852
"1671",1994,"Taylor",7048,15805,111395,732,78,0.0261,4.25,46994,8586,6471,2115,52197,7942,5747,2223,5768,26721,1753,3130,25634,13230,-420,12996,654,55580,52197,3383,13230,16613,447,0,16166,1568,256,17990,20273
"1672",1994,"Union",12352,17701,218640,768,87,0.0261,4.25,41595,6194,4437,1757,46031,7526,5427,1689,4539,26048,1327,2326,23197,10005,-348,9812,541,47789,46031,1758,10005,11763,723,0,11040,1137,183,12360,15547
"1673",1994,"Van Buren",7686,15947,122566,844,67,0.0261,4.25,33777,6976,5481,1495,39242,5354,2358,1599,4461,19178,1284,1969,22217,8943,-358,8820,481,40753,39242,1511,8943,10454,1663,0,8791,1217,190,10198,14599
"1674",1994,"Wapello",36265,17578,637477,907,103,0.0261,4.25,35888,5929,4463,1466,40079,3857,3558,2105,5407,16992,1391,1905,21856,11911,-274,11727,458,41817,40079,1738,11911,13649,1403,0,12246,914,151,13311,18896
"1675",1994,"Warren",38198,19819,757036,1083,92,0.0261,4.25,50866,8467,5718,2749,63378,5942,3793,3102,6913,25736,2267,3644,37717,15443,-471,15257,657,59333,63378,-4045,15443,11398,1276,0,10122,1522,277,11921,25130
"1676",1994,"Washington",20039,20786,416540,1603,105,0.0261,4.25,138737,12549,9014,3535,134849,34796,14724,4937,12359,99753,3595,6725,57713,26504,-994,25500,1998,151286,134849,16437,26504,42941,9680,0,33261,3916,612,37789,38984
"1677",1994,"Wayne",6974,15824,110357,597,68,0.0261,4.25,32118,9231,7338,1893,40563,3768,2807,1799,5198,16566,1378,1985,23628,9525,-389,9476,438,41349,40563,786,9525,10311,396,0,9915,591,109,10615,15552
"1678",1994,"Webster",39780,19592,779353,1852,119,0.0261,4.25,119625,14780,8105,6675,134017,16418,7912,6927,17912,42644,3657,6517,74674,44246,-343,42979,1610,134405,134017,388,44246,44634,6206,0,38428,3708,549,42685,76981
"1679",1994,"Winnebago",11794,19795,233461,1527,106,0.0261,4.25,54491,14487,12032,2455,65342,4232,2469,4356,10787,15628,2788,2522,38188,23738,-181,23121,798,68978,65342,3636,23738,27374,3097,0,24277,1149,196,25622,38863
"1680",1994,"Winneshiek",21129,18170,383908,1064,97,0.0261,4.25,126802,14966,9503,5463,127665,23600,12519,4847,11514,103809,4157,6335,64693,19830,-1083,19331,1582,141768,127665,14103,19830,33933,1124,0,32809,3204,571,36584,22993
"1681",1994,"Woodbury",102383,19840,2031262,1282,99,0.0261,4.25,128560,15160,8563,6597,154490,17154,33600,7022,19185,75938,3840,6902,66787,33675,-810,32804,1681,143720,154490,-10770,33675,22905,1744,0,21161,3358,548,25067,52622
"1682",1994,"Worth",7924,18757,148633,1471,98,0.0261,4.25,58391,12845,9617,3228,66139,8270,3782,4099,9951,22005,2766,1987,35284,20801,-213,20112,902,71236,66139,5097,20801,25898,2152,0,23746,1072,176,24994,36386
"1683",1994,"Wright",14470,19768,286038,1890,116,0.0261,4.25,109878,15604,9245,6359,126152,18382,8081,6067,15663,45946,3458,7530,66971,36766,-465,35595,1636,125482,126152,-670,36766,36096,3874,0,32222,4884,648,37754,63932
"1684",1995,"Adair",8366,17085,142935,937,85,0.0281,5.49,77528,10104,6050,4054,76602,8945,7060,3433,10354,38596,2053,3436,41321,-12126,-1005,-9875,-1246,87632,76602,11030,-12126,-1096,-326,0,-770,1738,330,1298,38932
"1685",1995,"Adams",4578,16457,75339,957,89,0.0281,5.49,44076,5733,4321,1412,45816,4551,4051,2103,5795,23664,1552,2002,25762,-6405,-849,-4858,-698,49809,45816,3993,-6405,-2412,-241,0,-2171,1058,194,-919,20412
"1686",1995,"Allamakee",14484,17064,247152,854,91,0.0281,5.49,94326,12494,6640,5854,79996,13197,5264,2518,6495,71264,2524,4312,45686,-11356,-1539,-8538,-1279,106820,79996,26824,-11356,15468,367,0,15101,2072,428,17601,23062
"1687",1995,"Appanoose",13723,15760,216277,615,NA,0.0281,5.49,24216,3865,2837,1028,26903,2110,2344,1018,3030,14130,865,819,16717,-2459,-676,-1363,-420,28081,26903,1178,-2459,-1281,-129,0,-1152,434,93,-625,10086
"1688",1995,"Audubon",6954,18960,131851,1441,104,0.0281,5.49,114190,9661,6766,2895,94009,12430,14346,4439,11615,56584,2432,3682,45065,-16373,-1209,-13593,-1571,123851,94009,29842,-16373,13469,550,0,12919,1948,358,15225,57606
"1689",1995,"Benton",23962,19664,471179,1693,120,0.0281,5.49,175066,16675,11240,5435,145658,15083,14957,6720,20513,63375,4017,6672,77696,-27873,-1235,-24375,-2263,191741,145658,46083,-27873,18210,1530,0,16680,3262,594,20536,111691
"1690",1995,"Black Hawk",126936,20044,2544313,1792,121,0.0281,5.49,147308,13834,8229,5605,106737,12833,7346,5570,15586,48869,3361,6606,55435,-24738,-1003,-21864,-1871,161142,106737,54405,-24738,29667,3461,0,26206,3973,684,30863,98439
"1691",1995,"Boone",25456,21534,548159,1858,113,0.0281,5.49,140616,11082,7719,3363,101054,8626,7578,5753,14488,33691,2575,5978,56056,-25979,-695,-23746,-1538,151698,101054,50644,-25979,24665,4442,0,20223,3372,559,24154,106925
"1692",1995,"Bremer",23183,20670,479197,1562,111,0.0281,5.49,116142,12353,7034,5319,84348,8566,5506,4381,12514,47295,2790,3965,46626,-19427,-823,-17211,-1393,128495,84348,44147,-19427,24720,1340,0,23380,2041,385,25806,68847
"1693",1995,"Buchanan",21141,17903,378495,1576,113,0.0281,5.49,142862,13609,9906,3703,119319,13176,8506,6082,17293,56260,3844,6528,63890,-24501,-1282,-21202,-2017,156471,119319,37152,-24501,12651,816,0,11835,3895,718,16448,86602
"1694",1995,"Buena Vista",20500,19279,395216,1861,118,0.0281,5.49,211760,16830,9226,7604,157937,32442,22021,6234,17121,100190,3929,6714,69476,-30839,-1459,-26468,-2912,228590,157937,70653,-30839,39814,4345,NA,35470,3624,622,39716,111570
"1695",1995,"Butler",15573,18610,289818,1646,115,0.0281,5.49,145468,13600,10157,3443,108189,12966,10194,5756,15855,57064,3335,4568,55515,-24323,-1182,-21263,-1878,159068,108189,50879,-24323,26556,1696,0,24860,2431,459,27750,88404
"1696",1995,"Calhoun",11473,19121,219375,1881,115,0.0281,5.49,164258,14257,8949,5308,121386,11390,11163,6134,17787,44669,3444,4559,66909,-29541,-992,-26738,-1811,178515,121386,57129,-29541,27588,1481,0,26107,1787,323,28217,119589
"1697",1995,"Carroll",21651,20422,442152,1665,115,0.0281,5.49,231503,15901,7358,8543,176950,29235,39232,6093,16215,135408,3974,5616,76585,-29158,-2730,-23545,-2883,247404,176950,70454,-29158,41296,4523,NA,36774,3028,640,40442,96095
"1698",1995,"Cass",15043,18641,280420,1260,98,0.0281,5.49,102597,9922,6675,3247,88700,7487,12081,4243,11788,43246,2454,3990,46657,-17127,-1074,-14774,-1279,112519,88700,23819,-17127,6692,500,0,6192,1830,345,8367,59351
"1699",1995,"Cedar",17742,20843,369791,1906,126,0.0281,5.49,143083,17137,11335,5802,120413,11956,9155,6061,16321,51295,3764,6313,66843,-24943,-1254,-21812,-1877,160220,120413,39807,-24943,14864,1267,0,13597,3148,554,17299,91788
"1700",1995,"Cerro Gordo",47196,20708,977330,1709,112,0.0281,5.49,136658,14960,10685,4275,99567,8890,4672,6094,15700,33732,3604,6133,54474,-25637,-669,-23274,-1694,151618,99567,52051,-25637,26414,2028,0,24386,3291,575,28252,102926
"1701",1995,"Cherokee",13635,19353,263876,1606,107,0.0281,5.49,159097,13710,7739,5971,123288,14605,15738,5085,13905,70822,3291,5184,65480,-24581,-1701,-21010,-1870,172807,123288,49519,-24581,24938,1425,0,23513,2713,493,26719,88275
"1702",1995,"Chickasaw",13297,19688,261786,1272,98,0.0281,5.49,133304,13389,8314,5075,100444,11972,12284,4915,13432,62945,3287,4827,49727,-20814,-1149,-17973,-1692,146693,100444,46249,-20814,25435,1883,0,23552,2340,469,26361,70359
"1703",1995,"Clarke",8486,14716,124879,723,NA,0.0281,5.49,27326,6044,4128,1916,31204,4385,2954,906,2359,21650,836,2230,17534,-2267,-822,-856,-589,33370,31204,2166,-2267,-101,NA,0,-95,989,165,1059,5676
"1704",1995,"Clay",17577,20703,363889,1732,107,0.0281,5.49,135344,13135,9297,3838,99068,10918,9088,4838,12507,47157,2747,5596,53374,-23294,-661,-21083,-1550,148479,99068,49411,-23294,26117,3302,0,22815,2979,516,26310,88187
"1705",1995,"Clayton",18871,18293,345213,1131,105,0.0281,5.49,177571,19538,10754,8784,155073,26225,9907,5813,14468,124255,4844,8189,85627,-21946,-2441,-16836,-2669,197109,155073,42036,-21946,20090,997,0,19093,4381,858,24332,53316
"1706",1995,"Clinton",51270,19582,1003992,1495,124,0.0281,5.49,169334,19099,13362,5737,130974,12546,19008,6286,18658,67011,3902,5670,64904,-29758,-1406,-26310,-2042,188433,130974,57459,-29758,27701,2562,0,25139,2667,555,28361,102323
"1707",1995,"Crawford",16761,18123,303765,1435,98,0.0281,5.49,152793,13424,9227,4197,128889,12889,16567,5838,17736,62598,3365,5300,67194,-25904,-1728,-22212,-1964,166217,128889,37328,-25904,11424,640,0,10784,2671,508,13963,90195
"1708",1995,"Dallas",34050,23610,803927,1523,109,0.0281,5.49,125781,15054,7329,7725,94139,5890,5291,4671,12423,32613,2473,7420,55971,-21844,-372,-20224,-1248,140835,94139,46696,-21844,24852,2210,0,22642,4631,806,28079,93168
"1709",1995,"Davis",8512,15292,130162,814,71,0.0281,5.49,42325,6604,4569,2035,49341,9355,3727,1325,4467,32457,1570,2240,26657,-3425,-982,-1543,-900,48929,49341,-412,-3425,-3837,-1676,0,-2161,1351,235,-575,9868
"1710",1995,"Decatur",8468,13423,113662,583,76,0.0281,5.49,43959,6362,4153,2209,45978,8945,6521,1067,3143,35844,1230,1950,23122,-2980,-1021,-1179,-780,50321,45978,4343,-2980,1363,240,0,1123,1103,196,2422,8115
"1711",1995,"Delaware",18347,17683,324430,1630,113,0.0281,5.49,205274,16716,10664,6052,168942,32459,16805,5423,15844,148428,5191,6219,87001,-27988,-3106,-21820,-3062,221990,168942,53048,-27988,25060,1451,NA,23610,3135,704,27449,56846
"1712",1995,"Des Moines",42936,20591,884089,1458,NA,0.0281,5.49,67601,7761,4561,3200,56250,5401,3447,3191,8778,22426,1832,2285,31316,-10690,-659,-9079,-952,75362,56250,19112,-10690,8422,945,0,7477,1036,220,8733,45175
"1713",1995,"Dickinson",15601,23839,371907,1573,97,0.0281,5.49,86494,8874,5854,3020,69964,7693,11115,3249,8613,33075,1803,2790,34701,-13681,-572,-12041,-1068,95368,69964,25404,-13681,11723,1355,0,10368,1027,184,11579,53419
"1714",1995,"Dubuque",88938,21450,1907728,1428,118,0.0281,5.49,190862,14405,7386,7019,159303,31782,18959,4314,11755,159521,4642,7086,80765,-19612,-3163,-13697,-2752,205267,159303,45964,-19612,26352,679,NA,25674,3456,753,29883,31341
"1715",1995,"Emmet",11403,18811,214507,1819,107,0.0281,5.49,97688,10083,7538,2545,70382,6390,8058,3320,9140,29971,2033,2636,38805,-17658,-643,-15962,-1053,107771,70382,37389,-17658,19731,1271,0,18460,1458,249,20167,67717
"1716",1995,"Fayette",22211,17473,388084,1414,108,0.0281,5.49,199201,18402,12201,6201,149580,20309,13523,6560,19954,103895,4823,7921,76490,-31402,-1960,-26835,-2607,217603,149580,68023,-31402,36621,2494,NA,34128,4709,863,39700,95306
"1717",1995,"Floyd",17001,18525,314949,1507,104,0.0281,5.49,122397,11946,8830,3116,97704,6692,6689,5529,14909,35594,3193,7009,53683,-20957,-742,-18746,-1469,134343,97704,36639,-20957,15682,1816,0,13866,3915,678,18459,86803
"1718",1995,"Franklin",11016,19225,211785,1784,116,0.0281,5.49,183087,15820,11043,4777,144241,30145,13181,6385,18284,68823,3770,6213,66263,-29692,-644,-26047,-3001,198907,144241,54666,-29692,24974,1630,0,23344,2917,516,26777,114264
"1719",1995,"Fremont",8172,18477,150993,1239,96,0.0281,5.49,82945,9589,5753,3836,77242,3647,8867,3908,11286,24152,1980,4886,42668,-13394,-485,-11875,-1034,92534,77242,15292,-13394,1898,293,0,1605,2822,488,4915,58793
"1720",1995,"Greene",10226,20119,205742,1639,113,0.0281,5.49,147192,16034,8761,7273,105084,6278,7680,5797,15891,31532,2580,4750,62108,-27604,-883,-25247,-1474,163226,105084,58142,-27604,30538,2973,0,27565,2360,426,30351,115660
"1721",1995,"Grundy",12244,23190,283936,1905,138,0.0281,5.49,170881,19530,8278,11252,120779,14099,12036,5474,17932,55405,2961,6885,61392,-27689,-962,-24721,-2006,190411,120779,69632,-27689,41943,5788,0,36155,3334,577,40066,115476
"1722",1995,"Guthrie",11241,18727,210512,1306,103,0.0281,5.49,101893,10781,7330,3451,87933,12370,6491,3491,10487,44469,2432,4646,48016,-16340,-799,-14066,-1475,112674,87933,24741,-16340,8401,776,0,7625,2986,594,11205,57424
"1723",1995,"Hamilton",16468,21403,352472,2026,119,0.0281,5.49,220259,16961,9944,7017,170575,38014,14981,6537,17442,99489,4167,10121,79313,-32263,-1526,-27442,-3295,237220,170575,66645,-32263,34382,3319,NA,31064,6655,1074,38793,120770
"1724",1995,"Hancock",12148,18952,230224,1787,114,0.0281,5.49,148427,15716,10163,5553,118152,13999,8232,6274,15990,48275,3850,4561,65246,-26679,-858,-23800,-2021,164143,118152,45991,-26679,19312,1622,0,17690,2557,469,20716,100152
"1725",1995,"Hardin",19103,20157,385059,1838,117,0.0281,5.49,210113,15650,9575,6075,149684,32750,15095,5884,15914,92677,3616,7772,68653,-31678,-1541,-27045,-3092,225763,149684,76079,-31678,44401,3936,NA,40466,4251,754,45471,117436
"1726",1995,"Harrison",15231,18496,281706,1265,101,0.0281,5.49,119270,9634,7398,2236,98229,6008,7158,5642,16048,30639,2881,4958,55534,-21786,-829,-19476,-1481,128904,98229,30675,-21786,8889,569,0,8320,2361,389,11070,88631
"1727",1995,"Henry",20001,18684,373706,1404,107,0.0281,5.49,74872,9108,6501,2607,69696,8108,3375,3754,10184,28766,2042,3249,38984,-11629,-615,-9821,-1193,83980,69696,14284,-11629,2655,297,0,2358,1344,241,3943,46106
"1728",1995,"Howard",9944,18287,181849,1134,87,0.0281,5.49,103433,11095,7795,3300,82455,8980,5733,4731,12418,40921,2902,3924,43767,-17795,-935,-15423,-1437,114528,82455,32073,-17795,14278,835,0,13443,2022,363,15828,62512
"1729",1995,"Humboldt",10457,21531,225145,1940,121,0.0281,5.49,124115,12581,7385,5196,86782,6272,6617,4604,13101,27916,2432,2878,50878,-22600,-550,-20767,-1283,136696,86782,49914,-22600,27314,1586,0,25728,1720,284,27732,96199
"1730",1995,"Ida",8206,18946,155474,1609,112,0.0281,5.49,109154,8356,6489,1867,81591,6961,10228,3621,11339,40785,2226,3309,43907,-18908,-1053,-16674,-1181,117510,81591,35919,-18908,17011,1017,0,15994,1631,304,17929,68369
"1731",1995,"Iowa",15136,21468,324942,1475,111,0.0281,5.49,103790,13874,9718,4156,92196,11104,8605,4281,12303,51946,2859,4371,48673,-15992,-1318,-13149,-1525,117664,92196,25468,-15992,9476,905,0,8571,2182,396,11149,51844
"1732",1995,"Jackson",20196,17307,349540,1260,107,0.0281,5.49,105170,14130,8569,5561,103632,14914,15350,3149,9889,77721,3161,3730,53439,-14226,-1934,-10707,-1585,119300,103632,15668,-14226,1442,66,0,1376,1730,383,3489,27449
"1733",1995,"Jasper",35406,21422,758473,1536,110,0.0281,5.49,165689,16572,10074,6498,125221,14911,10418,6463,17437,66499,3339,5938,66715,-27319,-1621,-23610,-2088,182261,125221,57040,-27319,29721,3576,0,26145,3262,593,30000,99190
"1734",1995,"Jefferson",16468,19621,323123,1080,NA,0.0281,5.49,52748,7170,5420,1750,49306,5052,3524,2473,6389,23539,1623,1975,28270,-6904,-576,-5553,-775,59918,49306,10612,-6904,3708,280,0,3428,943,184,4555,29209
"1735",1995,"Johnson",104488,22319,2332097,1849,114,0.0281,5.49,103500,12005,7514,4491,95538,15637,7175,4481,11837,54335,3144,4129,49135,-15235,-1199,-12260,-1776,115505,95538,19967,-15235,4732,375,0,4357,1924,370,6651,49165
"1736",1995,"Jones",20521,16364,335803,1416,118,0.0281,5.49,144818,13042,9207,3835,121773,16352,16725,4919,14751,81450,3763,5214,60049,-21905,-1804,-18101,-2000,157860,121773,36087,-21905,14182,1721,0,12461,2785,504,15750,63368
"1737",1995,"Keokuk",11597,17015,197321,1329,NA,0.0281,5.49,91781,12969,10793,2176,88231,12341,5403,3976,11421,45178,3117,3590,48383,-13904,-1126,-11199,-1579,104750,88231,16519,-13904,2615,270,0,2345,1849,334,4528,46603
"1738",1995,"Kossuth",17836,19119,341014,1899,119,0.0281,5.49,271780,24440,17691,6749,210345,17556,16072,11437,30464,78846,7002,8641,119173,-49507,-1736,-44652,-3119,296220,210345,85875,-49507,36368,2333,NA,34036,4037,751,38824,192934
"1739",1995,"Lee",39107,19365,757310,1222,NA,0.0281,5.49,75161,8431,4820,3611,70750,9135,5756,3354,9924,37360,2382,3843,36356,-9886,-941,-7702,-1243,83592,70750,12842,-9886,2956,400,0,2556,2288,426,5270,37801
"1740",1995,"Linn",181874,24079,4379322,1834,111,0.0281,5.49,118761,13123,8966,4157,105551,8768,7939,5461,14185,42357,3347,5395,60456,-19999,-1010,-17433,-1556,131884,105551,26333,-19999,6334,712,0,5622,2600,488,8710,76404
"1741",1995,"Louisa",11939,18392,219580,1642,NA,0.0281,5.49,75788,9488,6559,2929,64000,7275,3440,3397,8968,28331,1946,3466,35508,-11929,-517,-10403,-1009,85276,64000,21276,-11929,9347,1243,0,8104,1755,306,10165,47457
"1742",1995,"Lucas",9234,16420,151625,658,NA,0.0281,5.49,22182,5327,3995,1332,25118,2223,1957,795,2577,15895,817,854,15895,-2039,-639,-986,-414,27509,25118,2391,-2039,352,NA,0,336,453,106,895,6287
"1743",1995,"Lyon",11724,18119,212424,1565,97,0.0281,5.49,207383,13454,7236,6218,159865,28268,31048,5931,14322,124273,3859,6121,70316,-26540,-2477,-21329,-2734,220837,159865,60972,-26540,34432,4445,NA,29988,3367,654,34009,83110
"1744",1995,"Madison",13340,18805,250864,1113,95,0.0281,5.49,69403,7217,4246,2971,74009,12281,4730,3080,8123,35017,1965,4197,39633,-9318,-702,-7305,-1311,76620,74009,2611,-9318,-6707,-2884,0,-3823,2378,462,-983,34386
"1745",1995,"Mahaska",22055,18244,402370,1324,NA,0.0281,5.49,145603,13324,8850,4474,121539,20743,15122,4554,12786,84796,3088,5519,59727,-18567,-1641,-14789,-2137,158927,121539,37388,-18567,18821,2067,0,16754,3179,574,20507,60807
"1746",1995,"Marion",31143,19962,621671,1200,96,0.0281,5.49,69750,7388,4854,2534,65725,5831,5056,3718,8462,30737,2057,3520,37081,-9857,-816,-8058,-983,77138,65725,11413,-9857,1556,162,0,1394,1544,290,3228,39013
"1747",1995,"Marshall",39051,21684,846769,1623,111,0.0281,5.49,133805,18550,9797,8753,102185,8024,6644,5328,16130,38010,3173,6475,56411,-23849,-914,-21349,-1586,152355,102185,50170,-23849,26321,3457,0,22864,3299,595,26758,95795
"1748",1995,"Mills",13663,22160,302778,1302,102,0.0281,5.49,63865,6316,5007,1309,58232,2757,3614,3086,8841,13285,1651,2931,35352,-11951,-347,-10826,-778,70181,58232,11949,-11951,NA,0,0,-2,1486,260,1744,50580
"1749",1995,"Mitchell",10971,20217,221796,1434,103,0.0281,5.49,158423,11821,7579,4242,119368,22895,15254,4787,11583,83476,3492,6419,54938,-23173,-1581,-19316,-2276,170244,119368,50876,-23173,27703,2362,0,25341,3966,669,29976,74947
"1750",1995,"Monona",10059,17486,175892,1198,92,0.0281,5.49,104099,12010,7724,4286,95759,6589,10339,5672,15245,34444,2570,4433,50911,-18477,-846,-16174,-1457,116109,95759,20350,-18477,1873,116,0,1757,1966,350,4073,69655
"1751",1995,"Monroe",8203,17983,147514,821,NA,0.0281,5.49,30893,4475,2584,1891,34372,4211,3345,1089,2988,23142,1009,2293,19437,-2560,-745,-1297,-518,35368,34372,996,-2560,-1564,-205,0,-1359,850,172,-337,7751
"1752",1995,"Montgomery",11947,18948,226371,1146,94,0.0281,5.49,69032,10911,5012,5899,68229,6573,6007,3391,8759,28776,1788,4464,37247,-9919,-542,-8347,-1030,79943,68229,11714,-9919,1795,171,0,1624,2677,450,4751,40256
"1753",1995,"Muscatine",41440,21099,874334,1755,114,0.0281,5.49,82504,9510,6201,3309,69532,7396,4120,3453,9768,27263,2327,2940,39528,-14132,-635,-12363,-1134,92014,69532,22482,-14132,8350,862,0,7488,1856,322,9666,55241
"1754",1995,"O'Brien",15647,19517,305381,1973,111,0.0281,5.49,189413,16217,8748,7469,141275,22135,17258,6384,16192,83229,3735,5337,70234,-28130,-1687,-23968,-2475,205630,141275,64355,-28130,36225,2816,0,33409,2659,484,36552,106184
"1755",1995,"Osceola",7138,19240,137335,1717,102,0.0281,5.49,143376,11522,6103,5419,107605,17165,13354,4834,12083,67428,3029,4508,52632,-19829,-1119,-16905,-1805,154898,107605,47293,-19829,27464,3505,0,23959,2424,422,26805,75948
"1756",1995,"Page",16729,19222,321570,1020,84,0.0281,5.49,72041,10654,5506,5148,73658,5014,5235,3903,10206,28767,2046,5862,41392,-10750,-902,-8823,-1025,82695,73658,9037,-10750,-1713,-396,0,-1317,2961,514,2158,43274
"1757",1995,"Palo Alto",10260,18522,190036,1752,115,0.0281,5.49,152619,14109,10177,3932,115646,14197,11583,5331,14743,58329,3374,5522,60896,-24500,-964,-21607,-1929,166728,115646,51082,-24500,26582,2071,0,24511,2828,489,27828,94290
"1758",1995,"Plymouth",24339,20574,500756,1638,94,0.0281,5.49,255013,20512,11085,9427,195692,30295,34019,7622,20873,138204,5150,7788,89945,-35429,-3185,-28960,-3284,275525,195692,79833,-35429,44404,2449,NA,41956,3932,739,46627,116809
"1759",1995,"Pocahontas",9133,19582,178840,1893,114,0.0281,5.49,158186,15042,9584,5458,116374,10281,7117,6632,17540,36774,3404,4235,67165,-29906,-680,-27495,-1731,173228,116374,56854,-29906,26948,1625,0,25323,1818,325,27466,121412
"1760",1995,"Polk",354096,25940,9185126,1612,117,0.0281,5.49,85892,9367,5060,4307,59731,2649,2276,3941,9268,11212,1802,3861,35934,-16166,-247,-15077,-842,95259,59731,35528,-16166,19362,2204,0,17158,2320,390,19868,74680
"1761",1995,"Pottawattamie",83973,19787,1661601,1339,106,0.0281,5.49,198481,18362,11565,6797,172369,10872,21648,8660,23940,70202,4518,7419,95312,-31610,-1520,-27766,-2324,216843,172369,44474,-31610,12864,1712,NA,11153,3740,694,15587,128279
"1762",1995,"Poweshiek",18925,20500,387957,1483,111,0.0281,5.49,107364,13094,9889,3205,89734,9287,5844,4256,11568,42528,3232,4222,51325,-17424,-1105,-14903,-1416,120458,89734,30724,-17424,13300,1288,0,12012,2571,480,15063,64836
"1763",1995,"Ringgold",5382,14241,76643,692,75,0.0281,5.49,37389,9624,5707,3917,46497,7365,2710,1471,4629,26478,1660,2603,26059,-4002,-1244,-1955,-803,47013,46497,516,-4002,-3486,-152,0,-3334,1282,222,-1830,10911
"1764",1995,"Sac",12003,18316,219845,1738,110,0.0281,5.49,194134,12160,7639,4521,153275,25198,19427,6033,17351,95351,3650,7848,73768,-27889,-1913,-23458,-2518,206294,153275,53019,-27889,25130,1675,NA,23456,4337,742,28535,98783
"1765",1995,"Scott",156271,22629,3536285,2332,130,0.0281,5.49,109652,11163,6328,4835,87970,8213,6101,4576,13172,36561,2977,4145,48786,-19429,-841,-17168,-1420,120815,87970,32845,-19429,13416,1854,0,11562,2366,422,14350,73091
"1766",1995,"Shelby",13232,18871,249706,1369,103,0.0281,5.49,148275,12041,8670,3371,115435,12604,12261,5914,17168,58404,3309,4129,60050,-25422,-1278,-22224,-1920,160316,115435,44881,-25422,19459,1402,0,18057,2068,392,20517,89871
"1767",1995,"Sioux",31347,19132,599728,1766,107,0.0281,5.49,494778,27050,11893,15157,388634,90296,105924,10289,24211,367077,6894,16419,134601,-44975,-5315,-33135,-6525,521828,388634,133194,-44975,88219,7656,NA,80565,8784,1632,90981,127701
"1768",1995,"Story",76265,20399,1555767,1928,118,0.0281,5.49,149599,17102,8856,8246,109079,9013,7612,5668,15985,35312,2884,7561,60356,-27514,-694,-25185,-1635,166701,109079,57622,-27514,30108,4111,0,25997,3522,641,30160,114287
"1769",1995,"Tama",17951,18923,339683,1549,121,0.0281,5.49,142945,17779,12093,5686,114921,9309,6978,5919,18993,42252,3570,6296,63856,-25706,-1021,-22849,-1836,160724,114921,45803,-25706,20097,1288,0,18809,2777,475,22061,100693
"1770",1995,"Taylor",7069,13897,98237,806,74,0.0281,5.49,44381,8306,6024,2282,50515,7599,4545,2099,5910,26950,1668,2925,25769,-4974,-691,-3379,-904,52687,50515,2172,-4974,-2802,-159,0,-2643,1461,266,-916,17431
"1771",1995,"Union",12325,17462,215224,840,NA,0.0281,5.49,37935,5914,4127,1787,41047,5151,3962,1647,4618,23666,1154,1989,22526,-4307,-681,-2968,-658,43849,41047,2802,-4307,-1505,-236,0,-1269,931,172,-166,14269
"1772",1995,"Van Buren",7701,15266,117566,915,77,0.0281,5.49,32572,5809,4288,1521,37940,4351,1793,1495,4615,18464,1146,1962,22578,-3549,-658,-2253,-638,38381,37940,441,-3549,-3108,-1171,0,-1937,1293,223,-421,14108
"1773",1995,"Wapello",35990,18298,658556,983,101,0.0281,5.49,39489,5891,4097,1794,40540,3020,2676,2229,5900,16094,1383,1893,23439,-5573,-492,-4470,-611,45380,40540,4840,-5573,-733,-173,0,-560,927,171,538,23395
"1774",1995,"Warren",38645,20374,787354,1175,91,0.0281,5.49,58006,8276,4857,3419,61395,4562,2817,2984,7124,23894,2145,3319,38444,-9247,-848,-7568,-831,66282,61395,4887,-9247,-4360,-1028,0,-3332,1409,282,-1641,34112
"1775",1995,"Washington",20245,21062,426405,1737,NA,0.0281,5.49,155972,14371,9613,4758,131078,28874,12453,4963,13505,98719,3561,6683,61039,-18892,-1982,-14255,-2655,170343,131078,39265,-18892,20373,3421,0,16952,3842,672,21466,57253
"1776",1995,"Wayne",6939,14817,102814,646,63,0.0281,5.49,27967,7557,5559,1998,35259,2644,2323,1546,4673,15830,1158,1700,21215,-2999,-725,-1720,-554,35524,35259,265,-2999,-2734,-277,0,-2457,572,116,-1769,12137
"1777",1995,"Webster",39698,20431,811084,1983,113,0.0281,5.49,190736,18056,10545,7511,137059,13727,6586,6917,19483,42978,3502,6518,80326,-34544,-614,-31776,-2154,208792,137059,71733,-34544,37189,3295,0,33894,3626,607,38127,147758
"1778",1995,"Winnebago",11804,19589,231231,1632,109,0.0281,5.49,89314,11385,8586,2799,66648,3261,1958,4281,11846,14529,2626,2293,40383,-19265,-340,-17873,-1052,100699,66648,34051,-19265,14786,1432,0,13354,1107,209,14670,74785
"1779",1995,"Winneshiek",21114,18265,385639,1131,98,0.0281,5.49,144886,16898,10065,6833,123355,18710,9582,4814,12526,99596,4092,6021,67610,-20246,-1935,-16258,-2053,161784,123355,38429,-20246,18183,471,0,17712,3042,616,21370,45290
"1780",1995,"Woodbury",103346,20993,2169529,1324,92,0.0281,5.49,158713,20215,12128,8087,146614,13515,24287,7050,20537,70256,3712,6651,70862,-24905,-1495,-21218,-2192,178928,146614,32314,-24905,7409,401,0,7008,3273,597,10878,88457
"1781",1995,"Worth",7952,19034,151360,1584,96,0.0281,5.49,91365,11300,7495,3805,65274,6563,2693,4016,10685,19999,2587,1922,36808,-17496,-366,-15957,-1173,102665,65274,37391,-17496,19895,1153,0,18742,1059,198,19999,71366
"1782",1995,"Wright",14674,20421,299661,2014,119,0.0281,5.49,180413,18536,10501,8035,134465,20391,6675,5882,16686,53797,3316,8302,73213,-30886,-1163,-27279,-2444,198949,134465,64484,-30886,33598,2405,0,31193,5640,829,37662,126616
"1783",1996,"Adair",8363,20527,171669,1046,92,0.0293,5.01,84269,8870,4791,4079,78747,8586,6490,3800,11879,36671,1990,3379,42623,9591,-695,9693,593,93139,78747,14392,9591,23983,3677,0,20306,1766,306,22378,47598
"1784",1996,"Adams",4534,21240,96303,1070,92,0.0293,5.01,51973,5270,3961,1309,47501,4073,3844,2523,6841,22767,1568,2048,26604,5696,-697,6060,333,57243,47501,9742,5696,15438,712,0,14726,1104,182,16012,29206
"1785",1996,"Allamakee",14468,19020,275178,968,96,0.0293,5.01,92085,10735,4998,5737,78593,11126,4347,2796,7342,70271,2491,4096,46395,4817,-1102,5346,573,102820,78593,24227,4817,29044,1083,0,27961,1989,380,30330,21814
"1786",1996,"Appanoose",13752,17375,238940,714,NA,0.0293,5.01,26650,4011,3096,915,26173,1768,1838,1120,3278,12021,829,741,16599,2149,-405,2363,191,30661,26173,4488,2149,6637,385,0,6252,402,77,6731,14629
"1787",1996,"Audubon",6920,22518,155827,1647,113,0.0293,5.01,113206,6834,4235,2599,97182,12047,13396,5335,13864,58635,2430,3664,46446,10279,-1361,10868,772,120040,97182,22858,10279,33137,2428,0,30709,1900,315,32924,54571
"1788",1996,"Benton",24249,21694,526065,2023,121,0.0293,5.01,166842,11218,6481,4737,148145,12185,12565,7962,24249,58317,4122,6785,80277,19600,-1133,19689,1044,178060,148145,29915,19600,49515,6998,0,42517,3151,522,46190,108525
"1789",1996,"Black Hawk",127392,20839,2654710,2128,124,0.0293,5.01,139543,9492,4215,5277,109255,12055,7460,6234,17796,52991,3300,6213,56197,15206,-1338,15662,882,149035,109255,39780,15206,54986,10479,0,44507,3674,567,48748,86552
"1790",1996,"Boone",25742,23371,601620,2260,119,0.0293,5.01,125870,7696,4544,3152,105887,7827,7137,6791,17257,34665,2591,5904,58380,16949,-832,17042,739,133566,105887,27679,16949,44628,13541,0,31087,3335,481,34903,91205
"1791",1996,"Bremer",23301,22613,526917,1814,118,0.0293,5.01,110117,9125,3975,5150,86089,7427,5680,4935,14392,49226,2759,3784,47112,12338,-834,12530,642,119242,86089,33153,12338,45491,4061,0,41430,1907,323,43660,60891
"1792",1996,"Buchanan",21126,20138,425437,1840,117,0.0293,5.01,144576,8335,4942,3393,123306,12394,8721,6898,19914,60363,3829,6137,65413,16336,-1525,16903,958,152911,123306,29605,16336,45941,4973,0,40968,3579,595,45142,84213
"1793",1996,"Buena Vista",20506,21668,444329,2171,123,0.0293,5.01,211019,12017,4278,7739,163380,31208,23831,7199,19977,115828,4061,6424,70680,17957,-2070,18604,1423,223036,163380,59656,17957,77613,14847,NA,62765,3505,540,66810,95191
"1794",1996,"Butler",15531,21338,331404,1943,120,0.0293,5.01,144418,9561,6511,3050,111804,11340,10601,6672,18832,60286,3198,4325,56836,16098,-1473,16691,880,153979,111804,42175,16098,58273,5984,0,52289,2223,390,54902,84132
"1795",1996,"Calhoun",11426,22368,255578,2258,121,0.0293,5.01,155444,9291,4181,5110,127236,10677,11395,7000,20806,48239,3550,4799,69009,19294,-1309,19733,870,164735,127236,37499,19294,56793,5766,0,51027,1787,289,53103,107205
"1796",1996,"Carroll",21651,22934,496549,1950,124,0.0293,5.01,220886,12353,3990,8363,180838,27412,36104,7237,19429,135846,4087,5594,80975,15302,-3052,16953,1401,233239,180838,52401,15302,67703,12021,NA,55681,3017,602,59300,85040
"1797",1996,"Cass",15005,20968,314620,1406,104,0.0293,5.01,97110,7553,4707,2846,88584,6615,10747,4778,13214,39496,2346,3871,47013,11457,-881,11752,586,104663,88584,16079,11457,27536,3283,0,24253,1677,295,26225,57614
"1798",1996,"Cedar",17860,23731,423840,2196,131,0.0293,5.01,139118,12225,6428,5797,121888,9992,8798,6941,18643,51439,3632,6199,67683,16159,-1409,16714,854,151343,121888,29455,16159,45614,6173,0,39441,2922,460,42823,87679
"1799",1996,"Cerro Gordo",47080,22276,1048776,2001,114,0.0293,5.01,128842,10670,6473,4197,104928,8505,5201,7100,18247,39248,3573,5873,56429,16676,-928,16791,813,139512,104928,34584,16676,51260,6358,0,44902,3097,490,48489,89594
"1800",1996,"Cherokee",13450,22365,300814,1863,111,0.0293,5.01,152960,9624,4078,5546,126749,13743,14951,5842,16386,72549,3238,5156,67433,15003,-1879,15985,897,162584,126749,35835,15003,50838,5053,0,45785,2610,434,48829,80411
"1801",1996,"Chickasaw",13270,21813,289455,1476,107,0.0293,5.01,124373,9974,4968,5006,103402,11263,11720,5643,15629,65321,3340,4768,51039,11990,-1215,12395,810,134347,103402,30945,11990,42935,5269,0,37666,2303,438,40407,59052
"1802",1996,"Clarke",8663,16075,139259,830,75,0.0293,5.01,33150,6352,4454,1898,37734,5338,2853,1250,3125,23251,946,2987,21235,1297,-753,1747,303,39502,37734,1768,1297,3065,87,0,2978,1063,158,4199,9899
"1803",1996,"Clay",17601,23356,411096,2020,112,0.0293,5.01,132936,9015,5241,3774,101414,9929,9095,5599,14583,52112,2720,5147,54341,16226,-876,16369,733,141951,101414,40537,16226,56763,12590,0,44173,2665,420,47258,80824
"1804",1996,"Clayton",18930,20692,391707,1282,108,0.0293,5.01,180042,17045,8894,8151,158627,23958,9638,6833,16849,131547,4937,7953,88459,10005,-2270,11008,1267,197087,158627,38460,10005,48465,4109,0,44356,4232,761,49349,48495
"1805",1996,"Clinton",50793,21320,1082909,1739,133,0.0293,5.01,154388,13790,8319,5471,132432,11235,16189,7470,21795,61117,3917,5463,66363,18748,-1234,19015,967,168178,132432,35746,18748,54494,8395,0,46099,2430,470,48999,93271
"1806",1996,"Crawford",16775,20115,337430,1656,114,0.0293,5.01,143407,9507,5496,4011,132433,11452,15535,6828,20949,60680,3406,5268,68995,15908,-1734,16712,930,152914,132433,20481,15908,36389,3257,0,33132,2575,439,36146,82727
"1807",1996,"Dallas",35380,25755,911220,1816,112,0.0293,5.01,130963,11976,4338,7638,99891,5757,5572,5410,14352,37348,2530,7891,58379,16345,-381,16124,602,142939,99891,43048,16345,59393,8962,0,50431,4655,709,55795,93615
"1808",1996,"Davis",8428,17581,148174,915,73,0.0293,5.01,54488,6815,4845,1970,52072,9768,3813,1511,5237,35483,1680,2291,27772,2617,-1270,3426,461,61303,52072,9231,2617,11848,2971,0,8877,1374,203,10454,19005
"1809",1996,"Decatur",8459,15010,126971,677,74,0.0293,5.01,49498,6407,4389,2018,47178,9063,5227,1252,3706,33688,1254,1844,24832,2510,-735,2851,394,55905,47178,8727,2510,11237,2969,0,8268,1003,161,9432,15810
"1810",1996,"Delaware",18324,21051,385730,1869,117,0.0293,5.01,213039,12746,6718,6028,170508,28767,16276,6174,18630,156627,5192,5935,89534,14781,-3381,16737,1425,225785,170508,55277,14781,70058,6779,NA,63278,2887,628,66793,56412
"1811",1996,"Des Moines",42825,21884,937183,1605,117,0.0293,5.01,69115,6440,3366,3074,60064,5328,4097,3739,10441,25397,1946,2208,32305,7264,-883,7677,470,75555,60064,15491,7264,22755,4107,0,18648,953,194,19795,43718
"1812",1996,"Dickinson",15783,26445,417378,1836,100,0.0293,5.01,83259,6352,3360,2992,70213,7010,9461,3713,9953,29713,1786,2523,35767,9989,-569,10055,503,89611,70213,19398,9989,29387,5102,0,24285,832,135,25252,53546
"1813",1996,"Dubuque",89097,22310,1987711,1624,116,0.0293,5.01,192538,12654,5831,6823,157161,27586,17386,4941,13415,158985,4744,6884,82205,8820,-2775,10335,1260,205192,157161,48031,8820,56851,2116,NA,54734,3290,673,58697,33553
"1814",1996,"Emmet",11338,21121,239468,2122,114,0.0293,5.01,93458,6630,4052,2578,74893,6769,8246,3817,10708,33606,1943,2543,40867,11808,-824,12111,521,100088,74893,25195,11808,37003,4161,0,32842,1383,211,34436,59852
"1815",1996,"Fayette",22275,19634,437357,1623,120,0.0293,5.01,193474,13381,7286,6095,154188,18542,13886,7556,23213,111663,4932,7480,78579,17379,-2137,18280,1236,206855,154188,52667,17379,70046,8301,NA,61744,4426,737,66907,81811
"1816",1996,"Floyd",17028,20359,346676,1769,110,0.0293,5.01,116867,8005,5075,2930,104341,5750,6411,6458,17965,37601,3236,7421,57100,14335,-869,14504,700,124872,104341,20531,14335,34866,6573,0,28293,3952,612,32857,79266
"1817",1996,"Franklin",11030,23327,257294,2092,118,0.0293,5.01,190893,10439,5709,4730,160569,33879,15226,7625,22631,87010,3835,6400,70973,20364,-1036,19840,1560,201332,160569,40763,20364,61127,6238,NA,54888,2789,456,58133,103883
"1818",1996,"Fremont",8077,22565,182258,1361,95,0.0293,5.01,93546,7525,4000,3525,82018,3153,7545,4835,13775,20975,2048,4984,45678,13224,-372,13114,482,101071,82018,19053,13224,32277,7568,0,24709,2728,426,27863,72571
"1819",1996,"Greene",10333,22775,235337,1964,120,0.0293,5.01,135442,10120,4333,5787,110514,5853,7678,6680,18586,33319,2499,4476,64742,18516,-1125,18939,702,145562,110514,35048,18516,53564,8598,0,44966,2156,351,47473,102123
"1820",1996,"Grundy",12317,24786,305288,2294,141,0.0293,5.01,146527,15608,4780,10828,124129,12997,10455,6378,21141,56911,2976,6659,63523,16041,-1245,16326,960,162135,124129,38006,16041,54047,12415,0,41632,3158,488,45278,89616
"1821",1996,"Guthrie",11268,21065,237357,1516,105,0.0293,5.01,104771,8589,5305,3284,91429,11914,6427,3946,11753,48525,2450,4451,50488,11555,-707,11557,705,113360,91429,21931,11555,33486,5408,0,28078,2894,537,31509,56246
"1822",1996,"Hamilton",16356,24632,402882,2429,122,0.0293,5.01,228025,11830,4315,7515,181272,38486,18136,7479,20541,126465,4147,10033,82450,18589,-2583,19512,1660,239855,181272,58583,18589,77172,11803,NA,65368,6677,953,72998,101560
"1823",1996,"Hancock",12158,22152,269323,2086,118,0.0293,5.01,145566,10892,5652,5240,124173,13428,8286,7287,19015,54565,3800,4538,67819,17904,-1212,18135,981,156458,124173,32285,17904,50189,7828,0,42361,2592,428,45381,91001
"1824",1996,"Hardin",19062,22534,429534,2203,118,0.0293,5.01,207308,11184,5165,6019,158457,33448,16359,6818,18278,111869,3548,8075,71931,17201,-2402,18053,1550,218492,158457,60035,17201,77236,10117,NA,67118,4368,687,72173,95439
"1825",1996,"Harrison",15400,21742,334834,1427,104,0.0293,5.01,124705,6693,4757,1936,101320,5755,6189,6433,18346,29710,2800,4992,56805,17681,-709,17691,699,131398,101320,30078,17681,47759,4791,0,42968,2345,334,45647,94995
"1826",1996,"Henry",20025,20374,407997,1545,108,0.0293,5.01,78213,7514,5011,2503,73745,7207,3452,4432,12108,31581,2135,3251,41160,8608,-773,8812,569,85727,73745,11982,8608,20590,3769,0,16821,1253,202,18276,46632
"1827",1996,"Howard",9980,20505,204644,1316,91,0.0293,5.01,97369,8119,5192,2927,86223,7909,5813,5515,14477,42288,2960,3875,45674,10978,-932,11234,676,105488,86223,19265,10978,30243,3158,0,27085,1986,319,29390,55081
"1828",1996,"Humboldt",10475,24551,257174,2294,122,0.0293,5.01,113777,8474,3319,5155,89326,5585,6502,5163,15172,28664,2422,2842,51640,15959,-738,16097,600,122251,89326,32925,15959,48884,5197,0,43687,1731,247,45665,85113
"1829",1996,"Ida",8092,22434,181536,1855,114,0.0293,5.01,98563,5103,3511,1592,82785,6050,9129,4103,13371,39354,2252,3195,44685,11529,-1109,12084,554,103666,82785,20881,11529,32410,3464,0,28946,1566,263,30775,59209
"1830",1996,"Iowa",15332,24216,371281,1674,112,0.0293,5.01,103011,11449,7471,3978,93667,9814,7399,4901,14487,51293,2868,3908,50290,10088,-1311,10683,716,114460,93667,20793,10088,30881,4684,0,26197,1798,304,28299,51718
"1831",1996,"Jackson",20199,19104,385878,1449,112,0.0293,5.01,99408,12623,7270,5353,100603,12548,12865,3658,11671,72217,3188,3461,53212,6764,-1410,7448,726,112031,100603,11428,6764,18192,1215,0,16977,1481,330,18788,27191
"1832",1996,"Jasper",35715,23010,821785,1726,117,0.0293,5.01,149148,13040,6580,6460,127120,13041,9360,7484,20358,65727,3305,5816,67756,15633,-1716,16373,976,162188,127120,35068,15633,50701,10533,0,40168,3128,515,43811,83421
"1833",1996,"Jefferson",16517,21783,359794,1189,105,0.0293,5.01,56964,6339,4775,1564,49583,4472,3391,2765,7169,23684,1610,1829,28347,5728,-845,6217,356,63303,49583,13720,5728,19448,2444,0,17004,814,152,17970,33280
"1834",1996,"Johnson",105355,23453,2470899,2059,113,0.0293,5.01,103561,9887,6014,3873,95579,13336,6611,5179,13636,54572,3167,4008,49642,9060,-1392,9638,814,113448,95579,17869,9060,26929,3404,0,23525,1736,306,25567,48989
"1835",1996,"Jones",20522,18128,372028,1644,116,0.0293,5.01,141349,9157,5801,3356,122221,14016,15107,5644,17204,77234,3812,5068,61370,13737,-1648,14462,923,150506,122221,28285,13737,42022,8494,0,33528,2643,422,36593,64115
"1836",1996,"Keokuk",11486,19896,228530,1439,105,0.0293,5.01,95037,11083,8940,2143,92360,10934,5322,4622,13305,46952,3333,3499,51345,9662,-1328,10247,743,106120,92360,13760,9662,23422,4126,0,19296,1788,286,21370,48085
"1837",1996,"Kossuth",17645,22539,397701,2213,122,0.0293,5.01,252205,14763,8512,6251,218555,16947,16676,12710,35669,87754,6818,8243,121492,31435,-2360,32303,1492,266968,218555,48413,31435,79848,8572,NA,71275,3655,626,75556,164451
"1838",1996,"Lee",38781,21150,820226,1376,108,0.0293,5.01,80991,7819,4283,3536,71962,8235,5226,3839,11816,37795,2444,3662,36740,7818,-1059,8285,592,88810,71962,16848,7818,24666,5481,0,19185,2141,364,21690,43196
"1839",1996,"Linn",183167,25298,4633691,2136,120,0.0293,5.01,119521,9737,6027,3710,107854,7295,7459,6309,16325,39976,3343,5030,62093,14682,-957,14924,715,129258,107854,21404,14682,36086,6336,0,29750,2415,413,32578,79545
"1840",1996,"Louisa",12087,20159,243657,1831,106,0.0293,5.01,80589,7657,4865,2792,68987,7703,3812,3864,10333,35886,1974,3523,37778,8777,-673,8946,504,88246,68987,19259,8777,28036,6926,0,21110,1797,277,23184,44703
"1841",1996,"Lucas",9277,18082,167750,764,NA,0.0293,5.01,24939,5118,3963,1155,26616,1911,1738,982,3180,14715,857,805,17143,1442,-500,1746,196,30057,26616,3441,1442,4883,390,0,4493,400,93,4986,10224
"1842",1996,"Lyon",11797,21554,254268,1827,107,0.0293,5.01,209902,9930,4217,5713,162937,26591,27925,7045,17270,125393,4052,5819,74235,16317,-2768,17751,1334,219832,162937,56895,16317,73212,15511,NA,57700,3106,566,61372,84509
"1843",1996,"Madison",13480,21268,286688,1257,95,0.0293,5.01,72743,5875,3504,2371,75861,11482,4702,3620,9369,37158,1994,4082,40612,6318,-514,6204,628,78618,75861,2757,6318,9075,2007,0,7068,2299,424,9791,35585
"1844",1996,"Mahaska",22031,20321,447698,1457,114,0.0293,5.01,149469,10567,6211,4356,126488,19893,15575,5310,15135,93520,3110,5339,62126,10873,-1943,11774,1042,160036,126488,33548,10873,44421,8391,0,36030,3088,503,39621,55949
"1845",1996,"Marion",31280,21365,668294,1354,104,0.0293,5.01,67162,6798,4382,2416,67418,4697,4544,4372,10090,30220,2170,3265,38280,5579,-979,6099,459,73960,67418,6542,5579,12121,2185,0,9936,1427,234,11597,36942
"1846",1996,"Marshall",39103,22343,873678,1906,114,0.0293,5.01,118851,14632,6743,7889,105892,6992,6335,6080,18928,38658,3153,6348,58056,14514,-1072,14843,743,133483,105892,27591,14514,42105,9262,0,32843,3024,496,36363,80193
"1847",1996,"Mills",13819,25505,352449,1431,101,0.0293,5.01,66227,4112,3120,992,56987,2087,2523,3408,9875,10623,1571,2252,35271,10312,-282,10250,344,70339,56987,13352,10312,23664,3664,0,20000,977,158,21135,55604
"1848",1996,"Mitchell",10957,23176,253939,1683,107,0.0293,5.01,156592,8075,4152,3923,126767,23590,15371,5539,13643,93261,3608,6578,58438,12758,-1959,13565,1152,164667,126767,37900,12758,50658,8205,0,42453,4085,605,47143,63331
"1849",1996,"Monona",10069,20990,211348,1371,102,0.0293,5.01,104800,9638,5465,4173,97424,6081,9092,6676,17457,31556,2501,4277,51340,14934,-698,14944,688,114438,97424,17014,14934,31948,3350,0,28598,1801,288,30687,73244
"1850",1996,"Monroe",8129,19871,161535,920,NA,0.0293,5.01,37109,4872,2886,1986,38423,4405,2828,1461,4003,23207,1131,2797,21798,1970,-609,2321,258,41981,38423,3558,1970,5528,344,0,5184,799,144,6127,13902
"1851",1996,"Montgomery",11917,22198,264532,1259,101,0.0293,5.01,83433,9289,3599,5690,72149,6728,5763,4132,10404,31778,1696,4087,39339,9456,-413,9356,513,92722,72149,20573,9456,30029,4703,0,25326,2352,360,28038,51655
"1852",1996,"Muscatine",41274,22566,931374,2007,113,0.0293,5.01,77395,7380,3974,3406,72119,6337,4185,3964,11620,27997,2374,2811,40828,9086,-679,9234,531,84775,72119,12656,9086,21742,3652,0,18090,1800,277,20167,49398
"1853",1996,"O'Brien",15456,22657,350194,2303,116,0.0293,5.01,185448,11572,4288,7284,146472,20397,17747,7513,18844,89973,3809,5224,72938,17061,-2190,18070,1181,197020,146472,50548,17061,67609,8871,NA,58737,2470,403,61610,95475
"1854",1996,"Osceola",7156,22685,162337,2005,109,0.0293,5.01,145355,8602,3451,5151,113144,17732,13962,5634,14179,77660,2990,4440,54207,12178,-1545,12814,909,153957,113144,40813,12178,52991,11656,0,41335,2359,366,44060,67695
"1855",1996,"Page",17344,20913,362709,1120,90,0.0293,5.01,84861,9425,4555,4870,74189,4183,4486,4479,11971,26729,2016,5383,41671,10594,-768,10887,475,94286,74189,20097,10594,30691,3517,0,27174,2403,371,29948,58132
"1856",1996,"Palo Alto",10261,22649,232403,2042,119,0.0293,5.01,158431,9550,6069,3481,123399,14893,11841,6201,17400,69145,3372,5912,63780,16837,-1381,17249,969,167981,123399,44582,16837,61419,7885,0,53534,2946,459,56939,89286
"1857",1996,"Plymouth",24739,23127,572136,1888,98,0.0293,5.01,251270,16197,6656,9541,197993,28165,30828,8838,24629,139279,5128,7666,92739,20618,-3784,22829,1573,267467,197993,69474,20618,90092,8476,NA,81615,3728,624,85967,111991
"1858",1996,"Pocahontas",8970,23910,214476,2224,121,0.0293,5.01,147601,10059,4262,5797,120059,9697,6941,7553,20504,39813,3324,3954,68086,20506,-888,20566,828,157660,120059,37601,20506,58107,5944,0,52163,1650,268,54081,107788
"1859",1996,"Polk",357986,27130,9712165,1916,120,0.0293,5.01,73463,6821,2892,3929,61528,2190,2022,4532,10871,10329,1788,3696,36429,10919,-282,10807,394,80284,61528,18756,10919,29675,5597,0,24078,2151,321,26550,63134
"1860",1996,"Pottawattamie",84992,21357,1815145,1490,104,0.0293,5.01,186920,13683,7060,6623,177192,9656,18391,10045,28200,62490,4378,6748,99774,22558,-1197,22657,1098,200603,177192,23411,22558,45969,10212,NA,35756,3440,579,39775,124430
"1861",1996,"Poweshiek",19004,22238,422604,1674,110,0.0293,5.01,100641,10261,7237,3024,93324,8274,5330,4959,13516,44195,3357,4650,53238,10153,-1121,10604,670,110902,93324,17578,10153,27731,5146,0,22585,2766,458,25809,56446
"1862",1996,"Ringgold",5418,17647,95611,786,75,0.0293,5.01,45649,10301,5954,4347,49012,7634,2470,1693,5304,28176,1694,2872,27345,2461,-1395,3454,402,55950,49012,6938,2461,9399,165,0,9234,1386,202,10822,17473
"1863",1996,"Sac",11968,22510,269403,2035,124,0.0293,5.01,198684,8063,3582,4481,159025,24769,18401,6862,20243,103531,3591,7841,77318,17548,-2604,18917,1235,206747,159025,47722,17548,65270,7184,NA,58085,4411,664,63160,95153
"1864",1996,"Scott",156751,24039,3768104,2735,140,0.0293,5.01,99632,8192,4168,4024,90250,7055,5760,5305,15457,36035,2985,3792,49896,11667,-932,11935,664,107824,90250,17574,11667,29241,6643,0,22598,2095,336,25029,63597
"1865",1996,"Shelby",13311,21775,289849,1546,109,0.0293,5.01,137806,7818,4490,3328,117123,10946,11178,6850,20086,56278,3267,3939,60857,16384,-1265,16753,896,145624,117123,28501,16384,44885,5270,0,39615,1858,332,41805,81528
"1866",1996,"Sioux",31196,22063,688291,2050,116,0.0293,5.01,495768,20306,6065,14241,385668,85230,98098,12084,27929,376789,6985,16337,139005,21620,-6572,24963,3229,516074,385668,130406,21620,152026,21723,NA,130301,8838,1466,140605,118979
"1867",1996,"Story",76937,21707,1670077,2329,123,0.0293,5.01,134989,11954,4219,7735,114597,8102,7525,6720,19452,37766,2965,7301,62532,17801,-895,17903,793,146943,114597,32346,17801,50147,11995,0,38152,3343,563,42058,97223
"1868",1996,"Tama",17885,20257,362305,1833,132,0.0293,5.01,127427,12994,7486,5508,118986,8218,6452,6754,21863,42441,3560,6290,65849,15706,-1082,15931,857,140421,118986,21435,15706,37141,3833,0,33308,2679,409,36396,84986
"1869",1996,"Taylor",7069,18007,127288,901,80,0.0293,5.01,57510,7918,6024,1894,51672,7966,4511,2338,6706,29721,1677,2776,25698,5416,-499,5465,450,65428,51672,13756,5416,19172,560,0,18612,1341,215,20168,27789
"1870",1996,"Union",12459,18779,233970,955,96,0.0293,5.01,41129,5024,3639,1385,40811,3958,3180,2007,5536,20803,1126,1844,23160,3208,-786,3705,289,46153,40811,5342,3208,8550,682,0,7868,741,129,8738,20326
"1871",1996,"Van Buren",7669,18101,138816,1027,85,0.0293,5.01,43544,5587,4402,1185,40049,4092,1636,1729,5533,18545,1135,2022,23902,4168,-636,4497,307,49131,40049,9082,4168,13250,2457,0,10793,1331,200,12324,24999
"1872",1996,"Wapello",36052,19460,701554,1081,105,0.0293,5.01,45591,5405,3707,1698,43053,2591,2396,2748,7091,15806,1451,1891,24885,5694,-438,5837,295,50996,43053,7943,5694,13637,1649,0,11988,921,153,13062,29785
"1873",1996,"Warren",39180,21646,848077,1370,104,0.0293,5.01,56367,7275,4000,3275,61808,3821,2374,3383,8127,21803,2146,3076,38881,6079,-666,6365,380,63642,61808,1834,6079,7913,920,0,6993,1282,227,8502,34564
"1874",1996,"Washington",20349,23747,483237,1882,123,0.0293,5.01,173605,11969,7140,4829,137169,26486,14162,5856,16252,115796,3728,6708,63977,10715,-2919,12358,1276,185574,137169,48405,10715,59120,16692,0,42428,3712,577,46717,57809
"1875",1996,"Wayne",6936,17368,120466,751,NA,0.0293,5.01,33243,7655,6040,1615,35698,2287,2110,1770,5264,14239,1163,1699,21405,3320,-500,3566,254,40898,35698,5200,3320,8520,560,0,7960,545,101,8606,19004
"1876",1996,"Webster",39461,21914,864760,2379,126,0.0293,5.01,175158,10648,4192,6456,147207,12697,7433,8112,23356,51818,3548,6550,85511,23136,-901,22996,1041,185806,147207,38599,23136,61735,10376,0,51359,3499,521,55379,123340
"1877",1996,"Winnebago",11829,21585,255328,1905,111,0.0293,5.01,79009,7934,5482,2452,71045,2745,1981,4952,14315,15140,2613,2117,42322,12842,-408,12748,502,86943,71045,15898,12842,28740,4650,0,24090,1049,175,25314,63869
"1878",1996,"Winneshiek",21128,20243,427695,1298,109,0.0293,5.01,141876,14064,7529,6535,125920,16300,8886,5622,15018,101295,4260,5765,70069,10067,-1559,10662,964,155940,125920,30020,10067,40087,1826,0,38261,2854,538,41653,40581
"1879",1996,"Woodbury",103994,22647,2355121,1517,102,0.0293,5.01,153953,15997,8427,7570,147731,11685,18674,8309,24272,60754,3797,6497,74497,18141,-1274,18381,1034,169950,147731,22219,18141,40360,3616,0,36744,3141,512,40397,93199
"1880",1996,"Worth",8001,20934,167494,1854,96,0.0293,5.01,77283,7587,4152,3435,64774,5482,2458,4406,12040,20545,2428,1784,36176,10894,-402,10745,551,84870,64774,20096,10894,30990,3359,0,27631,1028,174,28833,56738
"1881",1996,"Wright",14662,24039,352458,2380,129,0.0293,5.01,180759,12488,4791,7697,148311,23776,6919,6715,19633,71892,3366,8833,79069,19286,-2065,20056,1295,193247,148311,44936,19286,64222,7303,NA,56918,6172,765,63855,108867
"1882",1997,"Adair",8310,20911,173772,1179,96,0.0234,5.06,87970,10313,5499,4814,81154,9734,8225,3958,11034,38630,1922,3627,42654,73,-1058,796,335,98283,81154,17129,73,17202,2633,0,14569,2051,306,16926,49340
"1883",1997,"Adams",4503,21392,96329,1190,106,0.0234,5.06,53659,5663,4230,1433,47869,4286,5115,2833,6524,24146,1584,2293,25234,320,-425,557,188,59322,47869,11453,320,11773,492,0,11281,1322,189,12792,29513
"1884",1997,"Allamakee",14487,19628,284354,1096,110,0.0234,5.06,90640,12493,5865,6628,77104,10892,4165,2919,6723,65431,2456,4226,45723,-1211,-1181,-334,304,103133,77104,26029,-1211,24818,839,0,23979,2164,360,26503,25209
"1885",1997,"Appanoose",13677,17972,245806,799,76,0.0234,5.06,31232,4028,3076,952,28449,2201,2164,1482,3681,13270,1018,879,17024,-985,-1324,236,103,35260,28449,6811,-985,5826,329,0,5497,425,68,5990,17962
"1886",1997,"Audubon",6916,23228,160643,1784,118,0.0234,5.06,123436,8587,5822,2765,103235,13791,17248,5996,13353,63412,2425,3975,46447,2930,1394,1086,450,132023,103235,28788,2930,31718,2330,0,29388,2142,305,31835,60024
"1887",1997,"Benton",24453,22859,558976,2188,133,0.0234,5.06,174133,14719,9822,4897,149773,11254,14331,8839,23160,56423,4233,7492,80464,2584,201,1811,572,188852,149773,39079,2584,41663,5695,0,35968,3525,509,40002,117710
"1888",1997,"Black Hawk",127275,22195,2824899,2314,142,0.0234,5.06,140245,13198,7314,5884,110842,13374,9397,6569,16452,52757,3238,6520,55292,3571,1955,1121,495,153443,110842,42601,3571,46172,8328,0,37844,3976,525,42345,87488
"1889",1997,"Boone",26023,24155,628573,2453,125,0.0234,5.06,132905,10592,7101,3491,109366,8369,8866,7517,16595,35321,2608,6448,58963,2744,937,1386,421,143497,109366,34131,2744,36875,10808,0,26067,3877,471,30415,97584
"1890",1997,"Bremer",23292,23911,556939,1997,130,0.0234,5.06,112744,11941,6053,5888,86246,7533,7207,5231,13398,48620,2728,3950,46199,1590,507,731,352,124685,86246,38439,1590,40029,3404,0,36625,2061,297,38983,64124
"1891",1997,"Buchanan",21084,21417,451555,2015,132,0.0234,5.06,152138,12314,8642,3672,126281,13766,11338,7356,18566,61301,3810,6454,64991,3418,1888,990,540,164452,126281,38171,3418,41589,4278,0,37311,3814,544,41669,90837
"1892",1997,"Buena Vista",20427,22727,464242,2380,135,0.0234,5.06,222954,17383,8155,9228,168602,33075,30501,7338,17720,119029,3950,6355,69663,6205,3675,1705,825,240337,168602,71735,6205,77940,13761,NA,64180,3956,526,68662,103925
"1893",1997,"Butler",15501,21644,335497,2117,130,0.0234,5.06,144464,12036,8838,3198,114790,11622,13930,7264,18065,60083,3057,4388,56464,3599,1908,1201,490,156500,114790,41710,3599,45309,4304,0,41005,2337,362,43704,84381
"1894",1997,"Calhoun",11377,21936,249571,2458,135,0.0234,5.06,154234,13526,7709,5817,130544,11185,15761,7157,18757,52274,3488,5182,69014,4060,1808,1756,496,167760,130544,37216,4060,41276,4514,0,36762,2069,290,39121,101960
"1895",1997,"Carroll",21705,24076,522562,2125,136,0.0234,5.06,236567,16526,6858,9668,197803,30349,47511,8051,18779,147525,4202,5968,82943,5298,3048,1444,806,253093,197803,55290,5298,60588,9954,NA,50635,3369,597,54601,89042
"1896",1997,"Cass",14886,21721,323332,1558,120,0.0234,5.06,101737,9211,6256,2955,89974,6860,13794,5066,11998,41043,2234,4050,45972,694,-643,1019,318,110948,89974,20974,694,21668,2414,0,19254,1763,276,21293,60694
"1897",1997,"Cedar",18102,24346,440718,2340,139,0.0234,5.06,141723,16699,9891,6808,122058,9670,11172,7471,17246,51083,3493,6496,66510,2907,1233,1214,460,158422,122058,36364,2907,39271,4898,0,34373,3168,427,37968,90640
"1898",1997,"Cerro Gordo",47091,23183,1091722,2185,121,0.0234,5.06,133858,13879,9026,4853,107932,9612,6982,7764,17155,40841,3537,6179,56703,3171,1542,1166,463,147737,107932,39805,3171,42976,5065,0,37911,3403,469,41783,93017
"1899",1997,"Cherokee",13381,22881,306167,2026,122,0.0234,5.06,157967,12904,6788,6116,132720,15276,19399,6311,15608,76463,3183,5565,67378,3723,1668,1544,511,170871,132720,38151,3723,41874,4156,0,37718,2909,424,41051,81504
"1900",1997,"Chickasaw",13272,22777,302295,1627,112,0.0234,5.06,133715,12710,6897,5813,107239,12514,14696,6088,14713,68579,3390,5009,50829,1960,655,845,460,146425,107239,39186,1960,41146,4764,0,36382,2561,435,39378,65136
"1901",1997,"Clarke",8701,17689,153912,930,83,0.0234,5.06,41557,6727,4529,2198,42005,7552,3709,1615,3359,26333,1077,4118,20575,75,-355,247,183,48284,42005,6279,75,6354,148,0,6206,1318,171,7695,15224
"1902",1997,"Clay",17662,23778,419972,2215,124,0.0234,5.06,128919,11992,7622,4370,103699,10643,10639,6089,13755,51205,2686,5105,54782,3245,1118,1716,411,140911,103699,37212,3245,40457,8963,0,31494,2780,383,34657,77714
"1903",1997,"Clayton",18952,21771,412611,1452,122,0.0234,5.06,188304,18474,9506,8968,162292,25802,10967,7532,15872,126151,5030,8435,88654,1223,989,-480,714,206778,162292,44486,1223,45709,3936,0,41773,4675,734,47182,62153
"1904",1997,"Clinton",50635,21934,1110616,1880,141,0.0234,5.06,161897,18248,12091,6157,136340,11833,20182,8314,20593,63606,3934,5636,65848,942,-274,672,544,180145,136340,43805,942,44747,6670,0,38077,2508,428,41013,98291
"1905",1997,"Crawford",16864,20676,348674,1789,124,0.0234,5.06,156289,12173,7652,4521,138120,11954,20794,7492,19995,63882,3446,5693,68746,2662,636,1503,523,168462,138120,30342,2662,33004,2702,0,30302,2865,413,33580,92407
"1906",1997,"Dallas",36862,26800,987911,1977,116,0.0234,5.06,126174,15559,6662,8897,103007,6641,6778,5888,13419,38269,2589,8650,59042,2129,520,1265,344,141733,103007,38726,2129,40855,6061,0,34794,5452,706,40952,87905
"1907",1997,"Davis",8496,18265,155180,1001,80,0.0234,5.06,60511,6886,4649,2237,56181,11953,5199,1620,4960,39033,1792,2596,28061,876,204,395,277,67397,56181,11216,876,12092,3287,0,8805,1629,197,10631,21478
"1908",1997,"Decatur",8416,16146,135888,757,83,0.0234,5.06,56897,6527,4350,2177,50704,10807,6445,1378,3530,39947,1277,1902,25365,-897,-1433,301,235,63424,50704,12720,-897,11823,3230,0,8593,1058,147,9798,16950
"1909",1997,"Delaware",18380,21784,400397,2081,129,0.0234,5.06,214902,16422,9370,7052,174469,29943,19576,6611,17711,155399,5198,6030,89400,4274,3588,-102,788,231324,174469,56855,4274,61129,5742,0,55387,2943,585,58915,59503
"1910",1997,"Des Moines",42620,22894,975742,1732,128,0.0234,5.06,77443,7951,4461,3490,63386,6202,6393,4106,10028,27657,2063,2261,32333,2379,1324,781,274,85394,63386,22008,2379,24387,4146,0,20241,986,183,21410,49786
"1911",1997,"Dickinson",16076,26997,434009,2011,109,0.0234,5.06,79313,8841,5352,3489,73006,7530,12208,3991,9309,31568,1766,2431,35771,857,-219,795,281,88154,73006,15148,857,16005,2667,0,13338,766,106,14210,47745
"1912",1997,"Dubuque",88996,23150,2060281,1829,124,0.0234,5.06,189570,14866,7058,7808,158771,28011,19749,5323,12399,153023,4848,7237,81204,116,138,-706,684,204436,158771,45665,116,45781,1421,0,44360,3514,636,48510,36547
"1913",1997,"Emmet",11303,21946,248056,2327,121,0.0234,5.06,98801,9366,6314,3052,80108,8385,11182,4121,10146,37248,1850,2717,41707,2519,1232,981,306,108167,80108,28059,2519,30578,3354,0,27224,1538,202,28964,61553
"1914",1997,"Fayette",22261,20163,448839,1812,132,0.0234,5.06,200210,17471,10420,7051,158580,19959,17410,8175,21847,112101,5040,7822,78327,2997,1616,686,695,217681,158580,59101,2997,62098,7218,0,54880,4820,694,60394,88109
"1915",1997,"Floyd",17059,21207,361762,1924,126,0.0234,5.06,125009,10637,7380,3257,108758,5769,7799,7081,17448,37911,3277,8575,58809,2468,1056,1016,396,135646,108758,26888,2468,29356,5244,0,24112,4634,621,29367,87098
"1916",1997,"Franklin",10921,23465,256259,2291,127,0.0234,5.06,187852,14619,9110,5509,165349,39799,18735,7742,20457,88612,3532,6485,68599,5006,2889,1163,954,202471,165349,37122,5006,42128,3773,0,38355,3094,444,41893,99240
"1917",1997,"Fremont",7989,23141,184875,1539,106,0.0234,5.06,96889,8915,5069,3846,83728,2959,10038,5317,12892,22623,2009,5335,45178,1067,-413,1212,268,105804,83728,22076,1067,23143,5208,0,17935,3073,416,21424,74266
"1918",1997,"Greene",10402,21704,225763,2133,131,0.0234,5.06,135802,12847,7439,5408,114487,6444,10841,7232,17583,36226,2411,4535,65441,3546,1570,1580,396,148649,114487,34162,3546,37708,5760,0,31948,2285,320,34553,99576
"1919",1997,"Grundy",12335,26396,325590,2491,150,0.0234,5.06,164076,20417,8058,12359,127071,14134,12099,6975,20139,59182,2988,6975,63761,3821,1654,1622,545,184493,127071,57422,3821,61243,13239,0,48004,3498,467,51969,104894
"1920",1997,"Guthrie",11321,21876,247662,1638,115,0.0234,5.06,100286,10220,6529,3691,94697,13548,7617,4194,10670,49485,2467,4750,51451,1576,228,949,399,110506,94697,15809,1576,17385,2855,0,14530,3191,526,18247,50801
"1921",1997,"Hamilton",16371,25408,415951,2647,131,0.0234,5.06,244385,17528,8218,9310,195958,43090,25054,7613,18508,134853,3912,10780,87001,9096,6645,1464,987,261913,195958,65955,9096,75051,9885,NA,65167,7855,965,73987,109532
"1922",1997,"Hancock",12043,22572,271834,2286,133,0.0234,5.06,153650,14553,8688,5865,128605,15209,10074,7950,18260,55288,3744,5000,68368,3839,2288,987,564,168203,128605,39598,3839,43437,6781,0,36656,3025,431,40112,98362
"1923",1997,"Hardin",18981,23216,440668,2401,128,0.0234,5.06,217777,15801,8779,7022,171116,40162,20961,7420,16998,118016,3478,9038,73059,7624,5344,1362,918,233578,171116,62462,7624,70086,7540,0,62546,5186,697,68429,99761
"1924",1997,"Harrison",15498,22105,342579,1558,118,0.0234,5.06,125545,8999,7026,1973,102599,6510,7601,6897,16982,31985,2715,5511,56383,1610,-124,1342,392,134544,102599,31945,1610,33555,3088,0,30467,2742,330,33539,93560
"1925",1997,"Henry",20033,21492,430542,1666,117,0.0234,5.06,83829,9239,6411,2828,75996,7527,4179,4906,11622,30905,2230,3424,42108,1717,685,710,322,93068,75996,17072,1717,18789,3179,0,15610,1362,190,17162,52924
"1926",1997,"Howard",9966,21581,215078,1451,100,0.0234,5.06,105553,9811,6735,3076,88827,8171,7514,6032,13655,42749,3019,4219,46217,1686,445,863,378,115364,88827,26537,1686,28223,2991,0,25232,2265,312,27809,62804
"1927",1997,"Humboldt",10473,24297,254462,2510,132,0.0234,5.06,111503,12133,6109,6024,90336,5849,8393,5449,14217,28768,2412,3148,50868,2471,861,1277,333,123636,90336,33300,2471,35771,3927,0,31844,2044,248,34136,82735
"1928",1997,"Ida",8024,22591,181274,2002,134,0.0234,5.06,104511,7226,5630,1596,86773,6156,11717,4373,12743,41239,2278,3313,46193,2012,673,1031,308,111737,86773,24964,2012,26976,2916,0,24060,1740,253,26053,63272
"1929",1997,"Iowa",15423,26736,412342,1798,119,0.0234,5.06,114530,13668,9177,4491,94905,10184,8648,5277,13790,53007,2876,3723,50407,1581,505,677,399,128198,94905,33293,1581,34874,4864,0,30010,1686,255,31951,61523
"1930",1997,"Jackson",20155,20295,409039,1599,124,0.0234,5.06,103671,14348,8268,6080,99941,12254,14530,3986,11133,72354,3216,3416,51406,-1570,-1567,-397,394,118019,99941,18078,-1570,16508,938,0,15570,1377,296,17243,31317
"1931",1997,"Jasper",36087,23836,860175,1856,128,0.0234,5.06,169064,16726,9179,7547,128480,13368,11430,8137,19225,66930,3270,6266,66784,3245,1124,1580,541,185790,128480,57310,3245,60555,12116,0,48439,3476,495,52410,102134
"1932",1997,"Jefferson",16628,24309,404202,1282,114,0.0234,5.06,63690,7205,5561,1644,50427,4647,4317,2907,6517,23472,1598,1750,28691,1198,332,672,194,70895,50427,20468,1198,21666,2621,0,19045,799,139,19983,40218
"1933",1997,"Johnson",106538,24289,2587673,2195,123,0.0234,5.06,110063,11931,7983,3948,95163,13248,7593,5623,12715,51784,3189,4118,48677,1918,773,702,443,121994,95163,26831,1918,28749,3374,0,25375,1794,273,27442,58279
"1934",1997,"Jones",20587,18818,387402,1784,125,0.0234,5.06,148601,11758,8283,3475,125418,14017,19007,6088,16231,78930,3860,5350,60865,955,154,295,506,160359,125418,34941,955,35896,7004,0,28892,2922,392,32206,69671
"1935",1997,"Keokuk",11444,21651,247774,1536,119,0.0234,5.06,105683,12961,10496,2465,94034,11439,6770,5112,12702,47120,3608,3793,50610,2484,1183,885,416,118644,94034,24610,2484,27094,4651,0,22443,2011,275,24729,58563
"1936",1997,"Kossuth",17552,23614,414465,2431,132,0.0234,5.06,268852,21869,15005,6864,220266,18296,22612,12685,32211,94118,6319,7974,120169,6588,3709,2032,847,290721,220266,70455,6588,77043,7833,NA,69211,3816,577,73604,174734
"1937",1997,"Lee",38720,21606,836590,1508,117,0.0234,5.06,84810,9062,4987,4075,72703,8739,6134,4129,11358,37268,2510,3799,36034,1722,760,628,334,93872,72703,21169,1722,22891,4875,0,18016,2310,342,20668,47542
"1938",1997,"Linn",185450,26445,4904199,2288,124,0.0234,5.06,125359,12234,8328,3906,108914,7019,9544,6845,15206,39826,3338,5078,61884,1492,NA,1143,390,137593,108914,28679,1492,30171,4798,0,25373,2587,382,28342,85533
"1939",1997,"Louisa",12050,21059,253762,1952,123,0.0234,5.06,89766,9394,6246,3148,71695,8828,4986,3857,8993,40980,1873,3714,39444,2968,946,1724,298,99160,71695,27465,2968,30433,6682,0,23751,2131,281,26163,48786
"1940",1997,"Lucas",9395,18852,177114,855,76,0.0234,5.06,31871,5178,4004,1174,30938,2369,2200,1411,3956,15998,1125,951,18926,-725,-1057,222,110,37049,30938,6111,-725,5386,425,0,4961,382,80,5423,15873
"1941",1997,"Lyon",11811,21417,252958,2000,112,0.0234,5.06,213495,12716,6487,6229,174939,29541,34535,7839,16790,132658,4247,6050,75937,4493,2208,1514,771,226211,174939,51272,4493,55765,11473,0,44292,3275,528,48095,80837
"1942",1997,"Madison",13585,22510,305795,1409,104,0.0234,5.06,76803,6582,4377,2205,77014,12674,5273,3990,8748,35605,2026,4337,39966,283,-655,581,357,83385,77014,6371,283,6654,1283,0,5371,2532,418,8321,41198
"1943",1997,"Mahaska",22126,21728,480760,1572,127,0.0234,5.06,167800,13262,8263,4999,134696,22532,20376,5810,14470,99021,3132,5706,62670,3982,2387,993,602,181062,134696,46366,3982,50348,9201,0,41147,3475,484,45106,68779
"1944",1997,"Marion",31317,22781,713433,1485,109,0.0234,5.06,79988,7598,4892,2706,68151,4322,5394,4820,9712,29783,2288,3277,38338,1085,116,715,254,87586,68151,19435,1085,20520,3691,0,16829,1532,208,18569,50205
"1945",1997,"Marshall",39242,23501,922212,2058,124,0.0234,5.06,129807,17295,8822,8473,110250,7132,8121,6524,17956,39652,3128,6764,60625,2814,877,1523,414,147102,110250,36852,2814,39666,8535,0,31131,3215,456,34802,90155
"1946",1997,"Mills",14145,26884,380271,1618,103,0.0234,5.06,66522,5233,4374,859,54053,1745,2432,3541,8936,9314,1489,1764,34146,907,-211,937,181,71755,54053,17702,907,18609,2769,0,15840,623,94,16557,57208
"1947",1997,"Mitchell",10941,23790,260288,1831,121,0.0234,5.06,173255,10939,6634,4305,139001,28543,20153,6016,12990,102580,3725,7385,60189,4023,2491,843,689,184194,139001,45193,4023,49216,8134,0,41082,4895,615,46592,70675
"1948",1997,"Monona",10121,21563,218235,1468,109,0.0234,5.06,110749,12215,7421,4794,99078,6627,11814,7369,16185,33523,2429,4409,50245,1344,-376,1334,386,122964,99078,23886,1344,25230,2630,0,22600,1919,266,24785,77226
"1949",1997,"Monroe",8132,20944,170320,1004,76,0.0234,5.06,42555,5293,2879,2414,40009,4963,3244,1676,3957,25463,1164,3129,21876,-202,-551,197,152,47848,40009,7839,-202,7637,448,0,7189,861,129,8179,17092
"1950",1997,"Montgomery",11889,22562,268235,1425,103,0.0234,5.06,86579,11332,4835,6497,75465,8096,6700,4696,9975,33966,1600,4142,40256,924,-224,846,302,97911,75465,22446,924,23370,3430,0,19940,2414,327,22681,52613
"1951",1997,"Muscatine",41280,23427,967063,2139,121,0.0234,5.06,82265,9749,5664,4085,73457,6334,5306,4276,11160,27357,2424,3044,40913,1755,370,1089,296,92014,73457,18557,1755,20312,3120,0,17192,2039,271,19502,54908
"1952",1997,"O'Brien",15498,23319,361391,2522,128,0.0234,5.06,195957,15563,7174,8389,156578,22171,23567,8289,17740,93531,3884,5515,75412,5556,3056,1831,669,211520,156578,54942,5556,60498,7545,0,52953,2667,369,55989,102426
"1953",1997,"Osceola",7167,22804,163438,2196,116,0.0234,5.06,149065,10838,5030,5808,117066,20069,18465,5791,12647,85309,2776,4485,52833,4021,2296,1185,540,159903,117066,42837,4021,46858,10242,0,36616,2673,353,39642,63756
"1954",1997,"Page",17374,21161,367646,1267,97,0.0234,5.06,86950,11016,5560,5456,73784,4040,5476,4832,11353,27678,1984,5386,40713,973,-394,1105,262,97966,73784,24182,973,25155,2514,0,22641,2242,290,25173,59272
"1955",1997,"Palo Alto",10254,22791,233698,2242,123,0.0234,5.06,168451,11885,8224,3661,131304,18296,14672,6770,16596,75071,3369,6844,64757,4414,2426,1413,575,180336,131304,49032,4414,53446,6495,0,46951,3540,478,50969,93380
"1956",1997,"Plymouth",24691,23799,587632,2038,105,0.0234,5.06,257696,21279,9966,11313,208514,30906,38556,9623,23481,144788,5103,8075,92770,6949,4113,1942,894,278975,208514,70461,6949,77410,7195,NA,70216,4096,584,74896,112908
"1957",1997,"Pocahontas",8864,24875,220489,2437,135,0.0234,5.06,153822,15406,8271,7135,118962,10034,8444,7565,18128,40147,3038,3669,68084,3693,1382,1842,469,169228,118962,50266,3693,53959,5221,0,48738,1739,245,50722,113675
"1958",1997,"Polk",360985,28324,10224457,2081,123,0.0234,5.06,79345,9065,4806,4259,61336,2088,2463,4897,10312,10011,1774,3961,35841,1134,NA,927,219,88410,61336,27074,1134,28208,5142,0,23066,2347,300,25713,69334
"1959",1997,"Pottawattamie",85677,22425,1921334,1656,116,0.0234,5.06,206823,17857,10252,7605,183957,10075,23830,10944,26857,66828,4231,6768,101252,1832,-803,2019,616,224680,183957,40723,1832,42555,9169,0,33386,3663,533,37582,139995
"1960",1997,"Poweshiek",18989,23972,455204,1798,126,0.0234,5.06,119103,12398,9028,3370,95576,8666,6296,5426,12771,45945,3487,5368,53562,1717,260,1081,376,131501,95576,35925,1717,37642,7296,0,30346,3380,474,34200,73158
"1961",1997,"Ringgold",5447,19231,104753,883,83,0.0234,5.06,52460,11449,5938,5511,52188,9286,3190,1828,4922,30936,1731,3422,27809,2017,1288,491,238,63909,52188,11721,2017,13738,170,0,13568,1728,206,15502,21524
"1962",1997,"Sac",11882,23226,275973,2217,130,0.0234,5.06,206387,12157,6931,5226,164898,26774,23322,6892,17929,112387,3319,8245,78417,6249,3828,1704,717,218544,164898,53646,6249,59895,6313,0,53582,5221,671,59474,94000
"1963",1997,"Scott",157228,25108,3947666,2913,150,0.0234,5.06,104603,10812,6851,3961,90857,7072,7042,5774,14666,34493,2991,3792,49520,1821,875,578,368,115415,90857,24558,1821,26379,5571,0,20808,2157,294,23259,70110
"1964",1997,"Shelby",13353,22661,302598,1685,111,0.0234,5.06,145286,11532,7676,3856,118918,11123,14183,7453,19003,57937,3225,4076,59855,2260,418,1345,497,156818,118918,37900,2260,40160,4360,0,35800,1910,304,38014,87349
"1965",1997,"Sioux",31473,23052,725525,2230,130,0.0234,5.06,532468,26315,10426,15889,423589,91488,124592,12869,25249,406566,6879,17270,145242,9353,5602,1860,1891,558783,423589,135194,9353,144547,19711,NA,124837,10248,1461,136546,125902
"1966",1997,"Story",77833,22830,1776938,2525,131,0.0234,5.06,145590,16532,7919,8613,118087,8567,9433,7466,19056,38499,3045,7675,62845,2925,928,1541,456,162122,118087,44035,2925,46960,11083,0,35877,3668,549,40094,107091
"1967",1997,"Tama",17950,21617,388032,1983,132,0.0234,5.06,142132,17228,10933,6295,120318,8515,7936,7246,20371,43334,3546,6825,65879,2292,377,1441,474,159360,120318,39042,2292,41334,3922,0,37412,3017,397,40826,98798
"1968",1997,"Taylor",7016,18995,133266,1016,84,0.0234,5.06,65274,7910,6063,1847,52958,9781,5179,2450,6163,30314,1688,2833,24864,585,-427,748,264,73184,52958,20226,585,20811,551,0,20260,1437,192,21889,34960
"1969",1997,"Union",12345,20088,247992,1072,115,0.0234,5.06,42402,5107,3875,1232,40097,3364,3482,2323,5457,19269,1115,1825,22531,153,-431,434,150,47509,40097,7412,153,7565,578,0,6987,660,100,7747,23133
"1970",1997,"Van Buren",7736,19174,148333,1124,89,0.0234,5.06,47621,5411,4351,1060,42222,4870,1950,2030,5783,19055,1212,2526,23851,289,-378,493,174,53032,42222,10810,289,11099,1921,0,9178,1593,199,10970,28566
"1971",1997,"Wapello",35980,19641,706699,1165,114,0.0234,5.06,49603,6141,4250,1891,44646,2594,2861,3154,6875,16179,1520,2053,25589,573,-173,578,168,55744,44646,11098,573,11671,1347,0,10324,1060,151,11535,33424
"1972",1997,"Warren",39510,23003,908850,1522,104,0.0234,5.06,65979,8825,5136,3689,60903,3708,2750,3606,7507,21773,2146,3020,38166,130,-672,596,206,74804,60903,13901,130,14031,1340,0,12691,1341,198,14230,44206
"1973",1997,"Washington",20512,25716,527488,2008,127,0.0234,5.06,185730,15105,9372,5733,146269,28652,19183,6473,15772,118476,3899,7284,65006,7611,5754,1130,727,200835,146269,54566,7611,62177,16708,0,45469,4188,555,50212,67254
"1974",1997,"Wayne",6910,18015,124481,840,78,0.0234,5.06,40334,7558,6031,1527,36907,2573,2701,2132,5380,15054,1311,1981,20829,-527,-1077,412,138,47892,36907,10985,-527,10458,739,0,9719,588,90,10397,25280
"1975",1997,"Webster",39268,22416,880224,2592,130,0.0234,5.06,181075,16018,9421,6597,153639,13859,9343,8923,22587,51920,3594,7194,88139,4705,2024,2084,597,197093,153639,43454,4705,48159,7784,0,40375,3962,505,44842,129155
"1976",1997,"Winnebago",11876,21341,253440,2087,122,0.0234,5.06,88309,9454,6907,2547,72259,2681,2562,5380,13943,15029,2601,2094,42998,1431,449,698,284,97763,72259,25504,1431,26935,4347,0,22588,1154,163,23905,73280
"1977",1997,"Winneshiek",21064,21308,448830,1449,119,0.0234,5.06,146059,16228,8845,7383,127899,16623,9763,6161,14522,96481,4432,5955,70443,-383,-775,-145,537,162287,127899,34388,-383,34005,1522,0,32483,3044,504,36031,49578
"1978",1997,"Woodbury",103728,23012,2386973,1628,105,0.0234,5.06,164521,19488,11081,8407,152402,11811,21594,9182,23176,62035,3882,6853,75904,1503,-519,1443,579,184009,152402,31607,1503,33110,2919,0,30191,3500,484,34175,102486
"1979",1997,"Worth",7929,22094,175185,2025,111,0.0234,5.06,85198,9723,6034,3689,64340,5848,2662,5017,12119,19076,2523,1986,34185,1554,412,834,308,94921,64340,30581,1554,32135,3351,0,28784,1153,173,30110,66122
"1980",1997,"Wright",14560,24547,357406,2604,134,0.0234,5.06,191635,18008,9264,8744,162456,31649,8177,7210,18671,82459,3414,10781,82554,7389,5141,1445,803,209643,162456,47187,7389,54576,5500,0,49076,7885,822,57783,109176
"1981",1998,"Adair",8305,21990,182624,1166,102,0.0155,4.78,78827,13931,8572,5359,84707,8130,8302,4563,11972,31872,1873,4155,45712,3198,215,2675,308,92758,84707,8051,3198,11249,1363,0,9886,2333,310,12529,46955
"1982",1998,"Adams",4493,22189,99694,1171,108,0.0155,4.78,47068,8223,6587,1636,47670,3906,4964,2922,6909,19464,1418,2576,24975,1934,160,1601,173,55291,47670,7621,1934,9555,313,0,9242,1350,172,10764,27604
"1983",1998,"Allamakee",14611,20779,303595,1121,100,0.0155,4.78,90816,15761,8508,7253,85198,9736,5676,3144,7300,65494,2338,5107,51897,2030,228,1518,284,106577,85198,21379,2030,23409,792,0,22617,2764,385,25766,25322
"1984",1998,"Appanoose",13761,18767,258251,798,83,0.0155,4.78,25028,5216,3947,1269,30322,1979,2077,1559,4082,10780,970,1000,18655,615,NA,505,98,30244,30322,-78,615,537,NA,0,511,479,67,1057,14248
"1985",1998,"Audubon",6893,22480,154955,1737,127,0.0155,4.78,102088,13810,9643,4167,105700,12722,16858,6082,13497,52269,2288,4714,49539,3958,543,3000,415,115898,105700,10198,3958,14156,890,0,13266,2666,335,16267,49819
"1986",1998,"Benton",24823,23526,583996,2116,138,0.0155,4.78,145969,22355,15906,6449,150010,10072,13166,9111,24273,47191,3899,8541,80948,6156,363,5269,524,168324,150010,18314,6156,24470,2855,0,21615,4170,527,26312,98778
"1987",1998,"Black Hawk",127743,23132,2954888,2296,137,0.0155,4.78,120316,19693,12882,6811,114461,11781,9559,6918,17088,43268,3020,7861,58234,5108,526,4131,451,140009,114461,25548,5108,30656,4836,0,25820,4972,602,31394,77048
"1988",1998,"Boone",25930,25136,651771,2338,125,0.0155,4.78,105939,16991,12531,4460,111688,7267,7978,7889,17983,27937,2622,7121,60828,5011,314,4305,392,122930,111688,11242,5011,16253,4160,0,12093,4378,500,16971,78002
"1989",1998,"Bremer",23322,24602,573773,2029,124,0.0155,4.78,100826,17188,10921,6267,92726,7522,8215,5577,14396,43859,2549,4687,49780,3974,331,3301,342,118014,92726,25288,3974,29262,2174,0,27088,2436,314,29838,56967
"1990",1998,"Buchanan",21088,22095,465949,2034,135,0.0155,4.78,132436,19046,13813,5233,130888,13080,10477,7855,18988,52172,3517,7331,69640,5685,588,4590,507,151482,130888,20594,5685,26279,2475,0,23804,4325,561,28690,80264
"1991",1998,"Buena Vista",20301,22903,464960,2275,122,0.0155,4.78,185567,24678,14810,9868,168958,30070,28860,7906,18587,100419,3795,7478,72262,6951,1149,5029,773,210245,168958,41287,6951,48238,7799,NA,40438,4546,549,45533,85148
"1992",1998,"Butler",15406,22173,341592,2095,135,0.0155,4.78,127417,18093,14035,4058,120138,11313,12308,7793,19089,50787,2948,6200,60487,5503,589,4443,471,145510,120138,25372,5503,30875,2450,0,28425,3531,451,32407,76630
"1993",1998,"Calhoun",11296,20822,235209,2345,123,0.0155,4.78,118058,21014,14526,6488,133512,10848,15145,7435,19722,43786,3170,5957,71235,5082,541,4071,470,139072,133512,5560,5082,10642,1074,0,9568,2609,325,12502,74272
"1994",1998,"Carroll",21703,24265,526615,2036,135,0.0155,4.78,201679,23740,13721,10019,204347,29719,46541,8237,19892,126596,3961,7270,88727,6537,1248,4500,789,225419,204347,21072,6537,27609,3576,NA,24032,4237,610,28879,75083
"1995",1998,"Cass",14794,23064,341202,1530,121,0.0155,4.78,94286,13677,10296,3381,96331,6908,14589,5414,12760,37524,2247,4750,49663,4004,258,3435,311,107963,96331,11632,4004,15636,1576,0,14060,2203,296,16559,56762
"1996",1998,"Cedar",18057,25559,461514,2312,139,0.0155,4.78,122781,22881,15597,7284,123776,8453,10275,7759,18190,40608,3248,7186,68665,5429,459,4549,421,145662,123776,21886,5429,27315,3003,0,24312,3633,445,28390,82173
"1997",1998,"Cerro Gordo",46950,24479,1149277,2169,117,0.0155,4.78,111540,22261,16097,6164,109047,8279,6343,8190,18343,32109,3295,6938,57659,5053,406,4223,424,133801,109047,24754,5053,29807,3091,0,26716,3881,489,31086,79431
"1998",1998,"Cherokee",13204,23626,311956,1948,118,0.0155,4.78,135691,20410,13598,6812,133451,14282,19313,6651,16522,64537,2955,6069,67659,5486,687,4316,483,156101,133451,22650,5486,28136,2336,0,25800,3054,398,29252,71154
"1999",1998,"Chickasaw",13237,23218,307331,1653,115,0.0155,4.78,116643,17928,11541,6387,114351,11437,16531,6609,15482,59849,3221,6450,54621,4380,419,3529,432,134571,114351,20220,4380,24600,2472,0,22128,3534,498,26160,56794
"2000",1998,"Clarke",8841,17867,157965,927,NA,0.0155,4.78,33164,7698,5430,2268,46536,7626,3562,1720,3644,22443,1011,5035,23938,847,258,403,186,40862,46536,-5674,847,-4827,-238,0,-4589,2237,256,-2096,10721
"2001",1998,"Clay",17550,24767,434653,2117,119,0.0155,4.78,118763,19429,14236,5193,113287,13106,11316,6645,14780,49590,2739,5956,58745,4951,540,3960,451,138192,113287,24905,4951,29856,5735,0,24121,3420,420,27961,69173
"2002",1998,"Clayton",18900,22422,423770,1485,128,0.0155,4.78,177650,25711,15139,10572,169464,22531,13060,7713,16565,118355,4750,9813,95032,5470,840,3983,647,203361,169464,33897,5470,39367,2758,NA,36608,5360,740,42708,59295
"2003",1998,"Clinton",50553,22744,1149781,1864,146,0.0155,4.78,137946,25229,17900,7329,138256,9934,18822,8697,22130,51353,3618,6658,68397,5798,295,5009,494,163175,138256,24919,5798,30717,3701,0,27016,2950,424,30390,86593
"2004",1998,"Crawford",16901,20725,350268,1731,126,0.0155,4.78,134780,18054,12794,5260,141433,11318,19904,7943,20803,52820,3241,6603,71621,5706,545,4669,492,152834,141433,11401,5706,17107,1169,0,15938,3239,412,19589,81960
"2005",1998,"Dallas",38152,27963,1066849,1897,111,0.0155,4.78,107369,21207,11763,9444,105501,6139,7150,6406,14549,30472,2397,9124,59736,4658,340,3991,327,128576,105501,23075,4658,27733,3541,0,24192,5581,680,30453,76897
"2006",1998,"Davis",8484,18466,156663,1006,98,0.0155,4.78,51228,9175,6094,3081,60962,9784,5148,2021,5600,31545,1637,2852,33920,1515,322,946,247,60403,60962,-559,1515,956,198,0,758,1731,200,2689,19683
"2007",1998,"Decatur",8538,16011,136698,757,85,0.0155,4.78,42959,7983,5345,2638,51480,9057,6103,1534,4080,30609,1304,2254,27148,707,116,379,212,50942,51480,-538,707,169,NA,0,136,1180,147,1463,12350
"2008",1998,"Delaware",18487,21837,403698,2110,131,0.0155,4.78,191148,23327,15098,8229,182848,26189,22695,7298,18768,137211,4953,7561,95384,6293,1183,4386,724,214475,182848,31627,6293,37920,2972,NA,34947,3817,612,39376,53937
"2009",1998,"Des Moines",42621,24193,1031125,1747,130,0.0155,4.78,57599,11322,7492,3830,62905,4946,5978,4335,10480,20187,1808,2454,32904,2530,325,1964,241,68921,62905,6016,2530,8546,1281,0,7265,1056,171,8492,37412
"2010",1998,"Dickinson",16236,28578,463991,1921,107,0.0155,4.78,74473,12346,8400,3946,72414,6282,11165,4460,9812,26206,1659,2795,36241,2971,130,2586,255,86819,72414,14405,2971,17376,2165,0,15211,986,120,16317,48267
"2011",1998,"Dubuque",88775,24605,2184330,1863,124,0.0155,4.78,175977,19146,10120,9026,161542,23228,23541,5351,13079,141213,4422,8108,83813,4228,746,2885,597,195123,161542,33581,4228,37809,1216,NA,36592,3972,619,41183,34764
"2012",1998,"Emmet",11247,23204,260975,2223,120,0.0155,4.78,88542,14500,11045,3455,83446,8534,11689,4507,10802,33275,1796,3069,43049,4053,500,3249,304,103042,83446,19596,4053,23649,2350,0,21299,1754,214,23267,55267
"2013",1998,"Fayette",22179,20137,446614,1847,124,0.0155,4.78,181691,24698,16532,8166,169300,18209,19107,8699,22805,100937,4664,9040,86776,6524,785,5093,646,206389,169300,37089,6524,43613,4427,NA,39185,5441,709,45335,80754
"2014",1998,"Floyd",16987,21531,365741,1950,121,0.0155,4.78,114857,16867,13003,3864,114067,6117,8102,7493,18083,32971,3172,9627,61473,5184,375,4428,381,131724,114067,17657,5184,22841,3448,0,19393,5336,658,25387,81886
"2015",1998,"Franklin",10875,24314,264420,2216,122,0.0155,4.78,162877,22637,16116,6521,164332,33106,19470,8121,21424,73431,3359,7577,71275,6788,1169,4782,837,185514,164332,21182,6788,27970,2264,0,25706,3742,469,29917,89446
"2016",1998,"Fremont",7993,23545,188196,1517,108,0.0155,4.78,74953,13195,8413,4782,82350,2526,7567,5652,13836,16749,1902,5552,45315,3416,76,3092,248,88148,82350,5798,3416,9214,1707,0,7507,3155,390,11052,58204
"2017",1998,"Greene",10442,21710,226692,2039,128,0.0155,4.78,109014,20350,14132,6218,115819,6337,10624,7600,18934,30366,2335,5402,64587,5162,448,4333,381,129364,115819,13545,5162,18707,2439,0,16268,2821,349,19438,78648
"2018",1998,"Grundy",12277,25995,319144,2416,147,0.0155,4.78,132860,27063,13978,13085,130871,12398,11550,7650,21153,47064,2884,8473,66763,5591,502,4586,503,159923,130871,29052,5591,34643,6336,0,28307,4287,518,33112,85796
"2019",1998,"Guthrie",11321,22831,258472,1589,116,0.0155,4.78,91049,14457,10293,4164,100033,13057,9223,4583,11228,43064,2400,5873,53669,3584,470,2726,388,105506,100033,5473,3584,9057,1219,0,7838,3907,537,12282,47985
"2020",1998,"Hamilton",16405,24875,408074,2526,126,0.0155,4.78,202987,25412,15392,10020,201747,40377,24968,8034,19220,113440,3889,13246,92013,7700,1730,5026,944,228399,201747,26652,7700,34352,4238,NA,30113,9516,1085,40714,89547
"2021",1998,"Hancock",12085,23049,278547,2226,126,0.0155,4.78,128227,21992,15178,6814,130932,14450,10713,8210,18857,46854,3504,5730,69468,5984,699,4755,530,150219,130932,19287,5984,25271,3494,0,21777,3453,436,25666,81373
"2022",1998,"Hardin",18912,23473,443914,2291,128,0.0155,4.78,190753,22984,14926,8058,178362,39340,22449,7873,17750,106759,3310,11185,76455,7323,1729,4687,907,213737,178362,35375,7323,42698,4840,NA,37857,6755,809,45421,83994
"2023",1998,"Harrison",15569,21833,339914,1527,116,0.0155,4.78,97459,14379,11718,2661,105841,5761,7452,7732,18517,25137,2570,6652,57157,4502,190,3940,372,111838,105841,5997,4502,10499,798,0,9701,3393,393,13487,72322
"2024",1998,"Henry",20285,22031,446901,1681,113,0.0155,4.78,69834,13531,9951,3580,79053,7306,4797,5080,11806,27500,2060,3814,44190,2923,269,2352,302,83365,79053,4312,2923,7235,1073,0,6162,1641,205,8008,42334
"2025",1998,"Howard",9999,22971,229689,1474,99,0.0155,4.78,96401,15126,11113,4013,94653,7890,7840,6347,14198,39678,2806,5175,50397,4039,327,3355,357,111527,94653,16874,4039,20913,1847,0,19066,2782,351,22199,56723
"2026",1998,"Humboldt",10462,24392,255192,2398,130,0.0155,4.78,86653,19022,12172,6850,90917,5494,7373,5690,14734,24115,2273,3795,51558,4053,290,3454,309,105675,90917,14758,4053,18811,1930,0,16881,2432,282,19595,62538
"2027",1998,"Ida",7928,23194,183883,1940,130,0.0155,4.78,92625,12244,10399,1845,89320,5991,11009,4777,13456,35890,2107,3956,48024,3941,384,3262,295,104869,89320,15549,3941,19490,1822,0,17668,2089,270,20027,56735
"2028",1998,"Iowa",15463,27876,431047,1775,126,0.0155,4.78,100674,18901,13489,5412,99380,8927,9054,5599,14764,42372,2823,4902,53311,3864,390,3104,370,119575,99380,20195,3864,24059,3436,0,20623,2482,382,23487,58302
"2029",1998,"Jackson",20225,21015,425034,1607,124,0.0155,4.78,94739,18113,11116,6997,105517,11289,17135,4015,11471,64254,3042,4331,54234,2765,292,2108,365,112852,105517,7335,2765,10100,557,0,9543,1794,297,11634,30485
"2030",1998,"Jasper",36898,24819,915780,1845,130,0.0155,4.78,136292,23785,15467,8318,131704,12530,10985,8521,20302,54072,3092,7105,69169,5657,532,4615,510,160077,131704,28373,5657,34030,5815,0,28215,4033,530,32778,82220
"2031",1998,"Jefferson",16553,25401,420466,1293,122,0.0155,4.78,49326,10382,8173,2209,53127,4167,4501,3157,7238,19330,1444,2110,30510,1938,196,1559,183,59708,53127,6581,1938,8519,916,0,7603,1039,150,8792,29996
"2032",1998,"Johnson",107819,26161,2820674,2197,125,0.0155,4.78,93048,15584,10640,4944,100295,12074,8265,6055,13703,44150,2949,5368,51881,3515,448,2650,417,108632,100295,8337,3515,11852,1209,0,10643,2521,328,13492,48898
"2033",1998,"Jones",20369,19719,401656,1773,125,0.0155,4.78,125347,18380,13586,4794,125369,11761,17864,6529,16593,64292,3526,6255,62841,4780,420,3911,449,143727,125369,18358,4780,23138,3713,0,19425,3531,437,23393,61055
"2034",1998,"Keokuk",11406,21087,240523,1553,125,0.0155,4.78,78805,17736,14579,3157,94527,9929,6987,5417,12900,39003,3268,4211,51815,3109,468,2255,386,96541,94527,2014,3109,5123,746,0,4377,2356,295,7028,39802
"2035",1998,"Kossuth",17321,23643,409520,2325,126,0.0155,4.78,229354,37354,28772,8582,229403,18954,24158,13845,33987,81551,5954,9577,122928,10555,1064,8658,833,266708,229403,37305,10555,47860,4230,NA,43629,4818,622,49069,147803
"2036",1998,"Lee",38544,22399,863336,1515,98,0.0155,4.78,65524,11335,6940,4395,73106,7257,5904,4474,11795,29934,2285,4163,37228,2452,327,1828,297,76859,73106,3753,2452,6205,1182,0,5023,2562,339,7924,35590
"2037",1998,"Linn",187210,29091,5446146,2252,122,0.0155,4.78,107292,16937,12026,4911,112084,6457,9252,7150,15864,32735,3121,6149,64091,4582,234,3987,361,124229,112084,12145,4582,16727,2314,0,14413,3153,406,17972,74557
"2038",1998,"Louisa",12114,21344,258564,1953,120,0.0155,4.78,72337,12734,8987,3747,72583,7751,5035,4234,9571,31311,1708,4441,39843,3601,288,3038,275,85071,72583,12488,3601,16089,3243,0,12846,2582,324,15752,41026
"2039",1998,"Lucas",9422,19664,185278,854,83,0.0155,4.78,24022,6458,4994,1464,32803,2424,2465,1462,4143,13002,1037,1323,19949,531,NA,377,106,30480,32803,-2323,531,-1792,-256,0,-1536,588,94,-854,11020
"2040",1998,"Lyon",11863,21028,249458,1911,113,0.0155,4.78,192756,21249,13175,8074,186476,29132,37719,8323,17353,119737,3974,7419,82556,6345,1095,4492,758,214005,186476,27529,6345,33874,5904,NA,27969,4026,549,32544,73019
"2041",1998,"Madison",13702,23441,321190,1384,99,0.0155,4.78,67806,9657,6495,3162,77318,10645,5303,4217,9246,30147,1829,4803,41275,2621,309,1994,318,77463,77318,145,2621,2766,450,0,2316,2855,399,5570,37659
"2042",1998,"Mahaska",22266,22946,510926,1585,129,0.0155,4.78,132510,17661,11972,5689,135050,20093,19479,6227,15340,78419,2896,6638,64377,4575,844,3174,557,150171,135050,15121,4575,19696,3086,0,16610,3898,489,20997,54091
"2043",1998,"Marion",31601,23755,750677,1491,107,0.0155,4.78,62902,10476,7546,2930,69813,4068,4621,4899,10175,23686,2046,4103,39901,2316,216,1866,234,73378,69813,3565,2316,5881,890,0,4991,1952,239,7182,39216
"2044",1998,"Marshall",39238,24387,956908,1996,129,0.0155,4.78,112172,22281,13241,9040,118795,6930,8662,7388,19344,34409,3126,8673,64672,4864,369,4091,404,134453,118795,15658,4864,20522,3767,0,16755,4362,543,21660,77763
"2045",1998,"Mills",14265,27286,389235,1595,107,0.0155,4.78,52155,8641,7200,1441,54101,1305,1948,4102,9691,6967,1359,2109,33587,2627,NA,2413,169,60796,54101,6695,2627,9322,1134,0,8188,758,100,9046,45188
"2046",1998,"Mitchell",10863,23386,254038,1855,115,0.0155,4.78,148866,17049,11206,5843,140573,24461,20123,6723,14043,84453,3512,8630,63081,5610,862,4121,627,165915,140573,25342,5610,30952,4030,0,26922,5687,671,33280,64413
"2047",1998,"Monona",10047,21566,216676,1433,111,0.0155,4.78,89481,18362,12872,5490,100663,5772,11097,7695,17197,27401,2287,5122,51493,4146,157,3634,355,107843,100663,7180,4146,11326,989,0,10337,2233,285,12855,62080
"2048",1998,"Monroe",8080,21509,173793,1010,83,0.0155,4.78,34153,6120,3694,2426,43385,4186,3750,1887,4413,21250,1106,3424,24619,767,145,482,140,40273,43385,-3112,767,-2345,-255,0,-2090,1131,143,-816,12903
"2049",1998,"Montgomery",11890,23211,275981,1404,109,0.0155,4.78,73962,14907,7756,7151,77138,7025,7394,5592,10476,28168,1597,5393,39661,2901,242,2376,283,88869,77138,11731,2901,14632,1996,0,12636,3307,394,16337,45794
"2050",1998,"Muscatine",41417,24823,1028110,2119,124,0.0155,4.78,69790,13335,8905,4430,75596,5804,5138,4713,11964,22176,2220,3532,42225,3283,196,2808,279,83125,75596,7529,3283,10812,1517,0,9295,2307,277,11879,47614
"2051",1998,"O'Brien",15457,23942,370068,2409,121,0.0155,4.78,173089,24129,15083,9046,162301,21597,24610,8765,18413,81622,3766,6379,78771,6771,971,5151,649,197218,162301,34917,6771,41688,4618,0,37070,3006,377,40453,91467
"2052",1998,"Osceola",7087,22289,157963,2097,111,0.0155,4.78,134266,17510,10411,7099,122020,19398,18533,6439,13323,75553,2655,5487,56185,4668,868,3271,529,151776,122020,29756,4668,34424,6651,0,27773,3351,400,31524,58713
"2053",1998,"Page",17330,21557,373576,1249,100,0.0155,4.78,68265,14097,8181,5916,76509,3586,5488,5278,12317,22223,1843,5743,42254,2876,178,2451,247,82362,76509,5853,2876,8729,730,0,7999,2436,289,10724,46042
"2054",1998,"Palo Alto",10245,21517,220440,2144,121,0.0155,4.78,146266,18856,14255,4601,140715,19680,17262,7054,17081,69033,3125,7639,68874,5831,897,4351,583,165122,140715,24407,5831,30238,3487,0,26751,4022,486,31259,77233
"2055",1998,"Plymouth",24578,24776,608944,1975,108,0.0155,4.78,232084,29547,17679,11868,216856,29497,38496,10338,24966,124830,4769,9748,99042,8897,1480,6555,862,261631,216856,44775,8897,53672,4341,NA,49330,5117,635,55082,107254
"2056",1998,"Pocahontas",8859,23143,205025,2329,121,0.0155,4.78,119810,23581,15730,7851,121914,9510,8501,8015,19603,35989,3037,4489,68759,5510,435,4624,451,143391,121914,21477,5510,26987,2412,0,24575,2208,271,27054,83821
"2057",1998,"Polk",365086,30543,11150854,2012,122,0.0155,4.78,64609,13697,8221,5476,66220,1827,2342,5345,11131,8223,1716,5097,38762,3010,67,2736,207,78306,66220,12086,3010,15096,2376,0,12720,3106,369,16195,56386
"2058",1998,"Pottawattamie",86609,23626,2046189,1628,113,0.0155,4.78,169578,26375,17866,8509,182516,8995,22734,11468,28289,52493,3999,7495,99536,7117,247,6302,568,195953,182516,13437,7117,20554,3842,0,16712,3963,515,21190,117085
"2059",1998,"Poweshiek",18814,25074,471737,1779,131,0.0155,4.78,99444,16472,12836,3636,99254,7866,6242,5893,13717,37812,3087,6232,56217,3905,339,3215,351,115916,99254,16662,3905,20567,3611,0,16956,3948,507,21411,61632
"2060",1998,"Ringgold",5441,18580,101095,878,90,0.0155,4.78,43067,12750,7522,5228,54691,8003,3438,2045,5330,25734,1611,3961,30303,1518,518,783,217,55817,54691,1126,1518,2644,NA,0,2611,2101,237,4949,17333
"2061",1998,"Sac",11852,21961,260283,2125,125,0.0155,4.78,165625,17978,12186,5792,166045,23798,23569,7901,18779,90684,3194,9195,79609,5975,1148,4160,667,183603,166045,17558,5975,23533,2101,0,21432,5759,679,27870,74941
"2062",1998,"Scott",157754,26844,4234771,2859,144,0.0155,4.78,90973,15643,10788,4855,93617,6662,7000,6207,15687,28245,2751,4489,50821,4279,338,3592,349,106616,93617,12999,4279,17278,3190,0,14088,2571,319,16978,62728
"2063",1998,"Shelby",13256,22200,294279,1650,114,0.0155,4.78,118480,17384,12768,4616,120369,9974,14166,7574,19563,46040,2971,5378,60743,4921,376,4094,451,135864,120369,15495,4921,20416,1701,0,18715,2807,381,21903,72440
"2064",1998,"Sioux",31649,22815,722085,2144,124,0.0155,4.78,477335,37504,19145,18359,437795,87701,127259,13374,26268,361924,6720,19872,156601,11889,2698,7342,1849,514839,437795,77044,11889,88933,10969,NA,77962,12076,1539,91577,115411
"2065",1998,"Story",78221,24180,1891363,2415,131,0.0155,4.78,117589,23818,14158,9660,120072,7377,8806,8089,20100,30582,2889,8537,64274,5370,296,4655,419,141407,120072,21335,5370,26705,5191,0,21514,4106,554,26174,87007
"2066",1998,"Tama",18070,21889,395540,1927,139,0.0155,4.78,117979,24985,17405,7580,125333,7572,7306,7962,21727,34384,3363,7393,70010,5178,293,4442,443,142964,125333,17631,5178,22809,2034,0,20775,3454,419,24648,83595
"2067",1998,"Taylor",7029,18672,131248,1006,93,0.0155,4.78,53183,11262,8762,2500,55981,8240,4862,2991,7079,25422,1575,3263,27971,1898,270,1382,246,64445,55981,8464,1898,10362,229,0,10133,1547,204,11884,27761
"2068",1998,"Union",12349,20582,254163,1066,116,0.0155,4.78,39230,7338,5698,1640,47216,4177,4894,2410,6102,19110,1178,2609,25846,1377,187,1026,164,46568,47216,-648,1377,729,NA,0,683,1142,145,1970,20120
"2069",1998,"Van Buren",7774,18840,146462,1130,98,0.0155,4.78,39459,7119,5460,1659,46423,4729,2279,2372,6153,17674,1206,2971,26713,1321,142,1007,172,46578,46423,155,1321,1476,217,0,1259,1824,209,3292,21785
"2070",1998,"Wapello",35948,20406,733564,1175,122,0.0155,4.78,39039,8415,6365,2050,47190,2370,2889,3455,7405,12936,1397,2464,27210,1572,105,1308,159,47454,47190,264,1572,1836,176,0,1660,1173,152,2985,26103
"2071",1998,"Warren",39911,23746,947711,1500,125,0.0155,4.78,53225,11876,7604,4272,63547,3101,2900,3762,8444,17512,1938,3502,39900,2142,124,1827,191,65101,63547,1554,2142,3696,324,0,3372,1523,196,5091,35713
"2072",1998,"Washington",20506,25525,523408,2031,131,0.0155,4.78,151287,20000,13765,6235,151558,26087,19719,6941,16488,98286,3778,8446,70099,5350,1514,3154,682,171287,151558,19729,5350,25079,5769,0,19310,4853,589,24752,53001
"2073",1998,"Wayne",6821,17982,122653,839,85,0.0155,4.78,32502,9769,7605,2164,39702,2188,2398,2506,6121,12864,1300,2312,22877,950,56,760,134,42271,39702,2569,950,3519,197,0,3322,722,94,4138,19638
"2074",1998,"Webster",39652,22904,908176,2473,127,0.0155,4.78,138769,25171,17075,8096,153532,12982,10101,9362,23651,42888,3323,7944,86169,6335,683,5093,559,163940,153532,10408,6335,16743,2390,0,14353,4214,496,19063,95881
"2075",1998,"Winnebago",11741,22649,265917,2033,116,0.0155,4.78,81462,15874,12392,3482,80175,4175,3275,5838,14708,17036,2417,2945,46817,4420,225,3900,295,97336,80175,17161,4420,21581,3214,0,18367,1816,225,20408,64426
"2076",1998,"Winneshiek",21251,22386,475730,1477,119,0.0155,4.78,142183,21709,12482,9227,140992,14718,12702,6943,15963,96283,4110,7382,79174,4122,417,3201,504,163892,140992,22900,4122,27022,1130,0,25892,3989,553,30434,45900
"2077",1998,"Woodbury",103653,24463,2535660,1587,112,0.0155,4.78,139804,26359,16380,9979,151677,10403,20949,9495,23598,49802,3545,7588,76099,6023,297,5205,521,166163,151677,14486,6023,20509,1559,0,18950,3970,495,23415,90002
"2078",1998,"Worth",7926,22808,180777,2011,110,0.0155,4.78,75668,15049,10337,4712,66728,5018,2396,5252,13018,15502,2306,2080,36658,3985,188,3515,282,90717,66728,23989,3985,27974,2364,0,25610,1186,161,26957,60166
"2079",1998,"Wright",14506,24553,356164,2489,129,0.0155,4.78,164310,24994,16031,8963,168075,31601,9056,7980,19528,77095,3270,12833,83807,6781,1308,4670,803,189304,168075,21229,6781,28010,2438,0,25572,9164,945,35681,87215
"2080",1999,"Adair",8298,22676,188166,1137,98,0.0219,4.64,77011,19962,14550,5412,86545,8149,9388,4731,11281,34221,1920,3924,47152,-1897,82,-1230,-749,96973,86545,10428,-1897,8531,823,0,7708,2138,310,10156,42790
"2081",1999,"Adams",4498,23029,103586,1141,104,0.0219,4.64,43219,12082,10383,1699,46271,4307,5424,2733,6350,20390,1335,2388,23734,-1086,NA,-683,-424,55301,46271,9030,-1086,7944,195,0,7749,1097,154,9000,22829
"2082",1999,"Allamakee",14651,21171,310179,1181,102,0.0219,4.64,83583,21845,14641,7204,90378,10525,6128,3068,6884,61170,2344,5058,56371,-533,NA,137,-703,105428,90378,15050,-533,14517,451,0,14066,2809,413,17288,22413
"2083",1999,"Appanoose",13709,19288,264420,803,84,0.0219,4.64,24070,7427,5933,1494,31350,2151,2199,1489,3929,11942,975,962,19645,-58,NA,182,-245,31497,31350,147,-58,89,NA,0,86,437,66,589,12128
"2084",1999,"Audubon",6896,21849,150669,1730,118,0.0219,4.64,92827,22329,17065,5264,107717,14197,18399,5589,11787,53760,2273,4605,50867,-2404,80,-1472,-1012,115156,107717,7439,-2404,5035,272,0,4763,2645,366,7774,39067
"2085",1999,"Benton",25214,24012,605426,2094,131,0.0219,4.64,130473,36387,28909,7478,144532,10903,12933,8516,22067,47334,3786,8011,78316,-4103,95,-2927,-1271,166860,144532,22328,-4103,18225,1695,0,16530,3956,546,21032,83139
"2086",1999,"Black Hawk",127786,23256,2971753,2298,131,0.0219,4.64,106439,30336,23199,7137,114245,12541,9900,6609,15384,40392,2970,7776,59065,-3410,78,-2399,-1089,136775,114245,22530,-3410,19120,2442,0,16678,4946,674,22298,66047
"2087",1999,"Boone",26164,25524,667812,2277,120,0.0219,4.64,92846,27514,22445,5069,109769,7616,8052,7511,16922,27457,2762,6479,60427,-3357,57,-2446,-968,120360,109769,10591,-3357,7234,1503,0,5731,3965,522,10218,65389
"2088",1999,"Bremer",23398,24345,569632,2078,118,0.0219,4.64,92008,24261,18207,6054,95056,9019,8518,5390,13432,40894,2510,4575,51612,-2623,78,-1824,-877,116269,95056,21213,-2623,18590,1111,0,17479,2313,327,20119,51114
"2089",1999,"Buchanan",21158,21896,463267,2052,130,0.0219,4.64,117626,30323,23924,6399,131375,15013,9872,7606,16807,49836,3421,6833,71823,-3675,82,-2499,-1258,147949,131375,16574,-3675,12899,1052,0,11847,3947,568,16362,67790
"2090",1999,"Buena Vista",20508,22826,468112,2203,120,0.0219,4.64,173283,35098,25527,9571,169729,33079,28698,7721,16912,98026,3840,7290,72189,-4663,330,-3073,-1920,208381,169729,38652,-4663,33989,4717,0,29272,4194,569,34035,75257
"2091",1999,"Butler",15286,21945,335450,2023,127,0.0219,4.64,110493,29774,25182,4592,122072,13271,11384,7580,17505,49446,2993,6971,62368,-3422,95,-2317,-1200,140267,122072,18195,-3422,14773,912,0,13861,4013,552,18426,61047
"2092",1999,"Calhoun",11190,21652,242282,2284,123,0.0219,4.64,118200,33521,26957,6564,133353,12682,16199,7006,17992,45068,3036,5633,70805,-4029,77,-2930,-1176,151721,133353,18368,-4029,14339,1188,0,13151,2614,358,16123,73132
"2093",1999,"Carroll",21631,24005,519259,1952,131,0.0219,4.64,196038,33652,24260,9392,215740,35042,52166,7640,18287,138203,3932,7313,91360,-4003,186,-2153,-2036,229690,215740,13950,-4003,9947,985,NA,8963,4251,631,13845,57835
"2094",1999,"Cass",14649,23433,343269,1528,118,0.0219,4.64,92416,19949,16441,3508,101213,8341,17273,5244,11780,43922,2368,4591,51616,-2371,82,-1649,-804,112365,101213,11152,-2371,8781,791,0,7990,2195,315,10500,48494
"2095",1999,"Cedar",18178,25947,471659,2308,130,0.0219,4.64,107502,32566,25493,7073,121122,8924,10199,7309,16650,38773,3183,6593,68264,-3369,66,-2418,-1017,140068,121122,18946,-3369,15577,1402,0,14175,3345,458,17978,68729
"2096",1999,"Cerro Gordo",46637,25246,1177414,2099,110,0.0219,4.64,97807,34565,27604,6961,105525,8600,5965,7836,17029,28809,3236,6432,56427,-3482,61,-2512,-1031,132372,105525,26847,-3482,23365,1966,0,21399,3560,503,25462,68998
"2097",1999,"Cherokee",13096,24280,317976,1918,123,0.0219,4.64,131226,31060,24175,6885,132834,16147,21491,6357,15178,68019,2892,5440,65329,-3708,95,-2594,-1209,162286,132834,29452,-3708,25744,1696,0,24048,2565,366,26979,63207
"2098",1999,"Chickasaw",13209,24300,320979,1666,115,0.0219,4.64,109215,27315,20947,6368,118026,12647,18229,6499,14136,58506,3224,6805,56486,-3030,66,-2023,-1073,136530,118026,18504,-3030,15474,1257,0,14217,3802,564,18583,50709
"2099",1999,"Clarke",8908,19251,171489,932,80,0.0219,4.64,34990,10339,8220,2119,50695,9229,3789,1662,3432,24364,1002,5039,26542,-320,NA,127,-494,45329,50695,-5366,-320,-5686,-324,0,-5362,2703,348,-2311,10626
"2100",1999,"Clay",17339,25089,435025,2033,115,0.0219,4.64,120577,29560,23995,5565,120143,18209,12261,6567,13792,54179,2922,5762,60630,-3877,186,-2789,-1274,150137,120143,29994,-3877,26117,4024,0,22093,3355,455,25903,66398
"2101",1999,"Clayton",18825,22040,414904,1622,124,0.0219,4.64,150626,36475,25224,11251,171317,23760,13214,7161,14991,107482,4727,9415,98049,-1810,158,-415,-1553,187101,171317,15784,-1810,13974,718,0,13256,4955,741,18952,43144
"2102",1999,"Clinton",50346,23247,1170373,1897,151,0.0219,4.64,131425,36455,28587,7868,137019,10016,19679,8252,20649,52528,3507,6494,68422,-3828,NA,-2685,-1187,167880,137019,30861,-3828,27033,2534,0,24499,2797,422,27718,78897
"2103",1999,"Crawford",16911,20767,351184,1718,112,0.0219,4.64,126085,31541,26007,5534,142272,12947,21546,7637,18764,55559,3213,6303,71862,-3521,79,-2375,-1225,157626,142272,15354,-3521,11833,649,0,11184,2943,410,14537,70526
"2104",1999,"Dallas",39691,29028,1152156,1911,111,0.0219,4.64,92199,29088,20007,9081,103124,6865,7689,6312,13698,28539,2337,8075,58148,-2902,103,-2183,-822,121287,103124,18163,-2902,15261,1555,0,13706,4543,636,18885,63660
"2105",1999,"Davis",8518,18045,153706,1027,86,0.0219,4.64,42748,12583,8896,3687,65495,9564,5304,2226,5480,30206,1574,2587,38760,-373,53,156,-582,55331,65495,-10164,-373,-10537,-5013,0,-5524,1469,198,-3857,12542
"2106",1999,"Decatur",8646,16351,141373,752,78,0.0219,4.64,42762,10676,7798,2878,52987,9114,6677,1544,4079,31654,1394,2212,27967,-221,NA,270,-509,53438,52987,451,-221,230,NA,0,201,1058,149,1408,11108
"2107",1999,"Delaware",18444,21867,403322,2181,130,0.0219,4.64,178128,36011,27327,8684,187095,27667,24151,7287,17263,126892,4973,7784,97970,-3549,154,-1942,-1761,214139,187095,27044,-3549,23495,1411,0,22084,3943,639,26666,51236
"2108",1999,"Des Moines",42515,24763,1052814,1695,117,0.0219,4.64,49605,17074,13258,3816,60125,4676,5705,4151,9498,16946,1663,2203,32229,-1645,NA,-1124,-557,66679,60125,6554,-1645,4909,596,0,4313,916,156,5385,32659
"2109",1999,"Dickinson",16333,29619,483771,1855,103,0.0219,4.64,69058,18229,14185,4044,71469,6286,12084,4503,8974,29063,1642,2650,35330,-2042,NA,-1453,-611,87287,71469,15818,-2042,13776,1358,0,12418,1003,133,13554,39995
"2110",1999,"Dubuque",88934,24840,2209146,1960,132,0.0219,4.64,159449,27157,17709,9448,159214,23078,24257,4870,11972,129261,4246,7487,83304,-1580,95,-301,-1374,186606,159214,27392,-1580,25812,768,0,25044,3638,593,29275,30188
"2111",1999,"Emmet",11103,22752,252619,2095,116,0.0219,4.64,82399,22281,18730,3551,85641,10394,13322,4464,9984,36035,1834,2854,42789,-2514,130,-1848,-796,104680,85641,19039,-2514,16525,1467,0,15058,1604,221,16883,46364
"2112",1999,"Fayette",22011,19958,439296,1884,124,0.0219,4.64,160178,38595,30040,8555,173849,20100,19271,8394,20643,93926,4546,8607,92288,-3714,146,-2269,-1591,198773,173849,24924,-3714,21210,1759,0,19451,4947,716,25114,66252
"2113",1999,"Floyd",16959,21372,362444,1932,117,0.0219,4.64,95666,27290,23156,4134,113906,7692,8764,7192,16243,33297,3232,8897,61886,-3136,62,-2229,-969,122956,113906,9050,-3136,5914,690,0,5224,4934,685,10843,62369
"2114",1999,"Franklin",10780,23740,255917,2094,121,0.0219,4.64,140993,35672,28715,6957,162210,33018,20008,7726,19461,67929,3366,7311,71320,-4304,316,-2677,-1943,176665,162210,14455,-4304,10151,687,0,9464,3621,497,13582,73064
"2115",1999,"Fremont",7997,25023,200105,1469,107,0.0219,4.64,69440,23756,18443,5313,78005,2598,6762,5448,12893,16922,1897,4706,43701,-2435,NA,-1836,-610,93196,78005,15191,-2435,12756,1829,0,10927,2578,358,13863,52518
"2116",1999,"Greene",10394,21970,228360,1966,130,0.0219,4.64,102105,30658,24185,6473,113177,7499,11870,7245,17705,32043,2379,5295,61184,-3649,58,-2740,-967,132763,113177,19586,-3649,15937,1638,0,14299,2778,380,17457,70062
"2117",1999,"Grundy",12332,25269,311616,2324,146,0.0219,4.64,120246,38590,26045,12545,130723,13140,11981,7595,19276,45348,2931,8471,67329,-4016,78,-2865,-1229,158836,130723,28113,-4016,24097,3441,0,20656,4195,569,25420,74898
"2118",1999,"Guthrie",11403,22765,259587,1585,109,0.0219,4.64,86933,22179,17912,4267,103614,15182,11333,4534,10251,44844,2456,5941,53917,-2316,163,-1483,-996,109112,103614,5498,-2316,3182,350,0,2832,3830,554,7216,42089
"2119",1999,"Hamilton",16387,24683,404488,2409,123,0.0219,4.64,183515,36258,26483,9775,205276,45279,25244,7613,17127,107596,4018,13234,92761,-4961,421,-2990,-2392,219773,205276,14497,-4961,9536,1019,NA,8518,9197,1202,18917,75919
"2120",1999,"Hancock",12091,23717,286759,2139,122,0.0219,4.64,115130,31885,24728,7157,129624,16583,11688,7691,16872,45671,3456,5406,67928,-3864,179,-2724,-1319,147015,129624,17391,-3864,13527,1572,0,11955,3168,440,15563,69459
"2121",1999,"Hardin",18784,22522,423053,2156,126,0.0219,4.64,180160,35025,26656,8369,186422,46402,24627,7576,16073,109416,3319,11368,77057,-4657,364,-2654,-2367,215185,186422,28763,-4657,24106,2630,0,21476,6934,925,29335,70744
"2122",1999,"Harrison",15510,23177,359474,1601,121,0.0219,4.64,92442,24426,21280,3146,104641,6165,8221,7827,17533,25487,2562,6579,55754,-3227,NA,-2317,-935,116868,104641,12227,-3227,9000,516,0,8484,3343,447,12274,66955
"2123",1999,"Henry",20351,22152,450817,1640,114,0.0219,4.64,59801,20061,16017,4044,79440,8549,5546,4772,10369,28041,2004,3537,44663,-1797,NA,-1090,-749,79862,79440,422,-1797,-1375,-520,0,-855,1581,218,944,31760
"2124",1999,"Howard",9950,23028,229126,1500,97,0.0219,4.64,89625,24256,19627,4629,96773,9188,7951,6058,12798,40003,2749,5195,52834,-2644,50,-1803,-891,113881,96773,17108,-2644,14464,980,0,13484,2732,384,16600,49622
"2125",1999,"Humboldt",10414,24385,253943,2303,126,0.0219,4.64,78897,27937,20885,7052,88257,6241,7074,5388,13233,24338,2256,3783,50282,-2860,55,-2155,-760,106834,88257,18577,-2860,15717,1400,0,14317,2317,310,16944,54559
"2126",1999,"Ida",7914,23923,189326,1932,130,0.0219,4.64,90963,20715,18778,1937,89830,7025,11701,4726,12330,39396,2053,3910,48085,-2589,58,-1903,-744,111678,89830,21848,-2589,19259,1492,0,17767,2011,286,20064,51567
"2127",1999,"Iowa",15570,29916,465786,1743,122,0.0219,4.64,94213,27706,21834,5872,101203,9455,10178,5386,13726,41889,2913,5251,54294,-2217,56,-1365,-908,121919,101203,20716,-2217,18499,2437,0,16062,2806,482,19350,52324
"2128",1999,"Jackson",20217,21633,437345,1663,118,0.0219,4.64,93035,25846,18555,7291,109119,12581,20001,3663,10238,66300,3032,4504,55100,-1048,57,-208,-897,118881,109119,9762,-1048,8714,436,0,8278,1861,302,10441,26735
"2129",1999,"Jasper",37096,25504,946083,1813,121,0.0219,4.64,126355,36616,28299,8317,131164,14201,11569,8094,18604,53696,3081,6624,68991,-3721,79,-2527,-1273,162971,131164,31807,-3721,28086,3834,0,24252,3767,552,28571,72659
"2130",1999,"Jefferson",16282,24879,405074,1268,118,0.0219,4.64,38945,15999,13394,2605,54288,4521,4953,3106,6976,19117,1373,2123,31236,-991,51,-583,-459,54944,54288,656,-991,-335,-95,0,-240,1071,162,993,19828
"2131",1999,"Johnson",109814,27723,3044334,2175,123,0.0219,4.64,86611,25531,19997,5534,102813,13315,8946,5908,12822,42678,2874,5713,53235,-2196,88,-1245,-1039,112142,102813,9329,-2196,7133,582,0,6551,2739,386,9676,43933
"2132",1999,"Jones",20220,20620,416944,1811,132,0.0219,4.64,117243,30763,25015,5748,122967,11851,18180,6348,14679,63804,3394,6037,62478,-2837,58,-1842,-1053,148006,122967,25039,-2837,22202,2716,0,19486,3416,476,23378,53439
"2133",1999,"Keokuk",11317,21806,246774,1534,111,0.0219,4.64,75038,28325,24729,3596,95679,10760,7897,5366,11730,38983,3221,3978,52727,-2043,77,-1172,-948,103363,95679,7684,-2043,5641,636,0,5005,2215,310,7530,36055
"2134",1999,"Kossuth",17258,22950,396072,2214,125,0.0219,4.64,208111,56805,47224,9581,232056,23414,27316,13683,31121,83478,5912,9549,121061,-6839,159,-4838,-2160,264916,232056,32860,-6839,26021,1876,NA,24146,4837,675,29658,124633
"2135",1999,"Lee",38281,22683,868315,1516,110,0.0219,4.64,58413,16578,12273,4305,71097,7223,5874,4392,10617,27870,2190,3764,37037,-1470,NA,-818,-700,74991,71097,3894,-1470,2424,381,0,2043,2288,330,4661,30543
"2136",1999,"Linn",189931,30443,5782163,2303,120,0.0219,4.64,97401,30244,24731,5513,110935,7185,9508,6775,14352,32293,3076,6114,63925,-2879,NA,-2031,-885,127645,110935,16710,-2879,13831,1563,0,12268,3073,430,15771,65108
"2137",1999,"Louisa",12174,22009,267942,1901,117,0.0219,4.64,65856,19062,15043,4019,71163,8223,5182,4208,8842,27907,1639,4350,38719,-1277,NA,-649,-671,84918,71163,13755,-1277,12478,1884,0,10594,2506,359,13459,37949
"2138",1999,"Lucas",9461,20419,193183,858,80,0.0219,4.64,23833,9220,7579,1641,33869,2965,3020,1375,3763,14148,1009,1487,20250,NA,NA,210,-269,33053,33869,-816,NA,-864,-119,0,-745,681,108,44,9685
"2139",1999,"Lyon",11812,21196,250371,1878,108,0.0219,4.64,196334,33635,24378,9257,199564,34559,43777,8015,15538,129072,3917,7451,86307,-4540,182,-2759,-1963,229969,199564,30405,-4540,25865,3584,NA,22282,3959,573,26814,67262
"2140",1999,"Madison",13898,24549,341187,1394,104,0.0219,4.64,58663,15039,11155,3884,75892,10738,5463,4042,8480,30180,1737,4383,41049,-1209,125,-587,-747,73702,75892,-2190,-1209,-3399,-1497,0,-1902,2596,382,1076,28483
"2141",1999,"Mahaska",22400,23758,532185,1581,115,0.0219,4.64,118452,27543,21674,5869,134615,21670,19919,6050,14116,74346,2821,6366,63673,-2860,153,-1648,-1365,145995,134615,11380,-2860,8520,1065,0,7455,3516,492,11463,44106
"2142",1999,"Marion",31879,25038,798176,1532,115,0.0219,4.64,58291,17169,14280,2889,68759,4628,4228,4514,9246,22635,1923,4226,39994,-1405,NA,-874,-572,75460,68759,6701,-1405,5296,619,0,4677,1972,268,6917,35656
"2143",1999,"Marshall",39313,24877,977976,1952,129,0.0219,4.64,105424,35282,26541,8741,122296,8116,9803,7544,18096,35666,3277,9046,66414,-3477,58,-2495,-1040,140706,122296,18410,-3477,14933,2133,0,12800,4623,637,18060,69758
"2144",1999,"Mills",14478,28331,410180,1605,106,0.0219,4.64,47261,16344,14417,1927,51373,1127,1773,4269,9126,6827,1307,2076,31695,-1872,NA,-1463,-416,63605,51373,12232,-1872,10360,946,0,9414,741,107,10262,40434
"2145",1999,"Mitchell",10895,23091,251575,1892,112,0.0219,4.64,135958,29924,23007,6917,142057,25264,21303,6786,13183,82530,3490,8359,63672,-3469,140,-2100,-1509,165882,142057,23825,-3469,20356,2023,0,18333,5300,719,24352,53428
"2146",1999,"Monona",10056,22893,230208,1468,115,0.0219,4.64,92722,29228,23533,5695,99466,6072,12234,7289,15861,29884,2268,4936,50806,-3238,NA,-2396,-864,121950,99466,22484,-3238,19246,1290,0,17956,2090,299,20345,62838
"2147",1999,"Monroe",8061,22075,177950,1043,NA,0.0219,4.64,32600,8503,6305,2198,45784,4245,4565,1917,4271,22277,1108,3133,26545,-173,NA,145,-342,41103,45784,-4681,-173,-4854,-562,0,-4292,1169,158,-2965,10323
"2148",1999,"Montgomery",11767,23437,275781,1364,113,0.0219,4.64,66870,21120,13985,7135,76273,7356,8569,5950,9544,28644,1671,5686,37497,-1824,80,-1201,-703,87990,76273,11717,-1824,9893,1121,0,8772,3522,466,12760,38226
"2149",1999,"Muscatine",41587,24991,1039317,2082,133,0.0219,4.64,63270,19978,15614,4364,74876,6437,5130,4701,11136,20828,2141,3365,41966,-1773,NA,-1105,-696,83248,74876,8372,-1773,6599,775,0,5824,2096,281,8201,42442
"2150",1999,"O'Brien",15200,24103,366364,2318,118,0.0219,4.64,169891,35772,26918,8854,167181,25348,27647,8406,16567,85217,3843,6126,79244,-4769,174,-3281,-1662,205663,167181,38482,-4769,33713,3117,0,30596,2721,377,33694,84674
"2151",1999,"Osceola",7049,22887,161330,1983,114,0.0219,4.64,134402,26628,18851,7777,126538,22611,19524,6472,12177,77724,2675,5551,57528,-3385,223,-2241,-1367,161030,126538,34492,-3385,31107,4942,0,26165,3337,446,29948,56678
"2152",1999,"Page",17112,22186,379644,1231,95,0.0219,4.64,65128,20208,14386,5822,75988,3848,6262,5220,11606,23509,1803,5014,42235,-1939,NA,-1351,-615,85336,75988,9348,-1939,7409,478,0,6931,2120,284,9335,41619
"2153",1999,"Palo Alto",10137,22017,223187,2051,121,0.0219,4.64,144474,30259,25102,5157,148248,25016,20687,6667,15225,73151,3055,7072,70526,-4121,232,-2799,-1554,174733,148248,26485,-4121,22364,2250,0,20114,3669,493,24276,71323
"2154",1999,"Plymouth",24774,25587,633902,2017,103,0.0219,4.64,227501,45472,34193,11279,225065,33992,41732,10069,23043,129721,4697,9741,101791,-5744,226,-3770,-2200,272973,225065,47908,-5744,42164,2840,NA,39325,5087,694,45106,97780
"2155",1999,"Pocahontas",8808,22653,199527,2257,119,0.0219,4.64,115549,35802,27964,7838,120594,10891,9053,7702,18408,37548,3185,4555,66800,-4151,85,-3091,-1145,151351,120594,30757,-4151,26606,1973,0,24633,2224,299,27156,78001
"2156",1999,"Polk",370592,31792,11781974,1973,124,0.0219,4.64,58989,20968,14730,6238,67547,1931,2476,5281,10434,8493,1746,5352,40327,-1966,NA,-1462,-518,79957,67547,12410,-1966,10444,1297,0,9147,3230,436,12813,50496
"2157",1999,"Pottawattamie",87153,24849,2165632,1707,114,0.0219,4.64,155265,40865,32232,8633,176906,9713,25764,10902,25856,55990,3980,6818,93873,-4716,NA,-3363,-1388,196130,176906,19224,-4716,14508,2288,0,12220,3444,492,16156,99275
"2158",1999,"Poweshiek",18797,25672,482549,1735,126,0.0219,4.64,91256,25966,22398,3568,99466,8639,6506,5796,12792,37018,2874,6034,56825,-2566,90,-1787,-869,117222,99466,17756,-2566,15190,2281,0,12909,3708,530,17147,54238
"2159",1999,"Ringgold",5449,18933,103164,889,87,0.0219,4.64,41853,15191,10792,4399,56526,8319,4033,2066,5013,26631,1579,3769,31747,-488,69,NA,-525,57044,56526,518,-488,NA,0,0,30,2039,269,2338,15222
"2160",1999,"Sac",11686,22327,260908,2084,128,0.0219,4.64,161567,30096,24271,5825,166095,25578,25886,8153,17062,89392,3236,8406,77774,-4261,182,-2800,-1643,191663,166095,25568,-4261,21307,1482,0,19825,5094,680,25599,72175
"2161",1999,"Scott",158765,27328,4338668,2970,151,0.0219,4.64,81167,25602,20271,5331,92892,7585,7437,6049,14570,27737,2666,4368,50217,-2657,53,-1836,-874,106769,92892,13877,-2657,11220,1722,0,9498,2456,341,12295,53430
"2162",1999,"Shelby",13179,22675,298838,1702,112,0.0219,4.64,111123,28093,23114,4979,118896,10818,15718,6976,17442,46315,2885,5739,59318,-3426,56,-2398,-1084,139216,118896,20320,-3426,16894,1027,0,15867,3146,458,19471,64808
"2163",1999,"Sioux",31669,22839,723276,2178,128,0.0219,4.64,493566,57588,38413,19175,466725,101477,140728,12607,23695,388575,6904,18853,162461,-8436,582,-4242,-4776,551154,466725,84429,-8436,75993,7866,NA,68128,11423,1611,81162,104991
"2164",1999,"Story",79372,24897,1976087,2327,126,0.0219,4.64,105592,34030,24209,9821,116508,7660,8526,7941,18397,28024,2888,7814,63282,-3765,NA,-2791,-1020,139622,116508,23114,-3765,19349,2842,0,16507,3704,550,20761,77568
"2165",1999,"Tama",18121,22249,403171,1903,132,0.0219,4.64,107702,39102,30891,8211,124923,8142,7174,7917,20118,32674,3361,6578,71633,-3603,NA,-2548,-1098,146804,124923,21881,-3603,18278,1413,0,16865,3176,438,20479,75028
"2166",1999,"Taylor",6905,19024,131358,1007,98,0.0219,4.64,50011,16367,13409,2958,58147,8344,4704,3244,7037,25185,1549,3117,30152,-1099,99,-594,-604,66378,58147,8231,-1099,7132,119,0,7013,1343,205,8561,24826
"2167",1999,"Union",12397,20650,255994,1074,107,0.0219,4.64,43204,11701,9778,1923,53557,5831,6960,2267,5919,23168,1294,2959,28327,-924,NA,-496,-462,54905,53557,1348,-924,424,NA,0,403,1395,192,1990,20036
"2168",1999,"Van Buren",7784,18321,142607,1134,110,0.0219,4.64,33372,10770,8623,2147,49200,5536,2682,2486,5683,19215,1260,2869,28684,-533,NA,-117,-445,44142,49200,-5058,-533,-5591,-2086,0,-3505,1675,221,-1609,14157
"2169",1999,"Wapello",36042,20617,743060,1195,118,0.0219,4.64,32902,12418,10393,2025,47709,2619,3090,3426,6927,12677,1351,2438,27858,-875,NA,-493,-397,45320,47709,-2389,-875,-3264,-751,0,-2513,1045,150,-1318,20225
"2170",1999,"Warren",40340,24920,1005286,1551,114,0.0219,4.64,47327,16695,12207,4488,63595,3113,3305,3559,8237,18025,1841,3368,40172,-1089,NA,-644,-466,64022,63595,427,-1089,-662,-153,0,-509,1392,196,1079,29302
"2171",1999,"Washington",20578,25449,523699,1960,126,0.0219,4.64,139139,31119,24956,6163,155792,28739,20665,6748,14948,92574,3853,8107,72732,-3137,264,-1707,-1694,170258,155792,14466,-3137,11329,2054,0,9275,4513,617,14405,46565
"2172",1999,"Wayne",6738,18496,124623,819,84,0.0219,4.64,31139,13729,11084,2645,40928,2239,2272,2639,6032,14411,1354,2251,24141,-218,NA,115,-342,44868,40928,3940,-218,3722,144,0,3578,710,101,4389,16728
"2173",1999,"Webster",40255,23447,943845,2375,124,0.0219,4.64,130015,39823,30921,8902,147161,14705,10780,8909,21480,39797,3238,7293,80756,-4705,179,-3498,-1386,169838,147161,22677,-4705,17972,2007,0,15965,3583,479,20027,90218
"2174",1999,"Winnebago",11660,21433,249912,1927,116,0.0219,4.64,69077,24400,20261,4139,84421,6514,4025,5738,13463,20517,2367,3302,49012,-2619,86,-1906,-799,93477,84421,9056,-2619,6437,841,0,5596,2115,290,8001,48560
"2175",1999,"Winneshiek",21289,22945,488477,1534,115,0.0219,4.64,134413,32337,22040,10297,148469,15753,13622,7061,15235,91554,4014,7508,85276,-1858,76,-680,-1254,166750,148469,18281,-1858,16423,587,0,15836,4132,602,20570,42859
"2176",1999,"Woodbury",103801,24911,2585772,1565,114,0.0219,4.64,132479,41306,30630,10676,148573,11074,24119,8908,20781,54144,3410,6930,73351,-4115,NA,-2918,-1240,173785,148573,25212,-4115,21097,1395,0,19702,3618,501,23821,78335
"2177",1999,"Worth",7890,21677,171029,1923,106,0.0219,4.64,61056,23402,18056,5346,66385,5190,2222,4987,12141,14415,2220,1793,37832,-2459,NA,-1816,-683,84458,66385,18073,-2459,15614,1056,0,14558,976,146,15680,46641
"2178",1999,"Wright",14379,24763,356070,2372,125,0.0219,4.64,157900,36794,28491,8303,171505,37887,10281,7988,17715,80712,3299,12463,81872,-4750,345,-2980,-2115,194694,171505,23189,-4750,18439,1270,0,17169,8512,1052,26733,77188
"2179",2000,"Adair",8223,25732,211595,1189,102,0.0338,5.82,82602,26105,21188,4917,89325,7413,10422,5156,11956,38131,2597,3977,47804,-4372,-403,-4363,394,108707,89325,19382,-4372,15010,1673,0,13337,2062,300,15699,44471
"2180",2000,"Adams",4476,26565,118903,1204,109,0.0338,5.82,52089,14637,13052,1585,46238,4354,6442,2707,6561,24551,1658,2411,22105,-2903,-395,-2732,224,66726,46238,20488,-2903,17585,459,0,17126,923,129,18178,27538
"2181",2000,"Allamakee",14674,22557,331005,1228,112,0.0338,5.82,93755,22279,15833,6446,96565,10430,7334,3170,7301,68314,3106,5338,59886,-2495,-868,-2003,376,116034,96565,19469,-2495,16974,697,0,16277,2966,430,19673,25441
"2182",2000,"Appanoose",13696,20573,281766,816,90,0.0338,5.82,29991,9173,7627,1546,33012,2144,2517,1504,4251,15366,1293,999,20304,-1596,-451,-1277,132,39164,33012,6152,-1596,4556,176,0,4380,419,64,4863,14625
"2183",2000,"Audubon",6804,25617,174296,1839,122,0.0338,5.82,112927,25339,19644,5695,114949,14527,24367,5435,11511,70474,2987,4778,51344,-4519,-560,-4493,534,138266,114949,23317,-4519,18798,1252,0,17546,2734,374,20654,42453
"2184",2000,"Benton",25326,26999,683765,2151,129,0.0338,5.82,143543,42796,35158,7638,144231,10819,15109,8428,22540,59087,4858,8078,74399,-8033,-439,-8261,667,186339,144231,42108,-8033,34075,3715,0,30360,3928,528,34816,84456
"2185",2000,"Black Hawk",128019,24735,3166570,2394,136,0.0338,5.82,115140,31430,24723,6707,118471,12226,13150,6685,15549,51189,3859,8090,58912,-6083,-400,-6252,569,146570,118471,28099,-6083,22016,3430,0,18586,5128,695,24409,63951
"2186",2000,"Boone",26251,27759,728711,2328,121,0.0338,5.82,98399,29807,24716,5091,110592,7301,8735,7573,17910,30316,3830,6216,59027,-6202,-207,-6512,517,128206,110592,17614,-6202,11412,2863,0,8549,3765,489,12803,68083
"2187",2000,"Bremer",23312,26620,620570,2176,120,0.0338,5.82,102574,29164,23896,5268,100710,9852,10595,5516,14096,48548,3268,4803,52580,-5194,-324,-5356,486,131738,100710,31028,-5194,25834,1852,0,23982,2304,325,26611,54026
"2188",2000,"Buchanan",21064,24040,506389,2142,136,0.0338,5.82,132209,38121,31338,6783,136250,15776,11995,7796,16668,64007,4399,6812,72804,-6466,-517,-6625,676,170330,136250,34080,-6466,27614,2968,0,24646,3798,554,28998,68202
"2189",2000,"Buena Vista",20361,24996,508946,2319,132,0.0338,5.82,200637,34903,26557,8346,180695,33367,38445,7978,17291,134313,5131,7565,70918,-6110,-283,-6858,1031,235540,180695,54845,-6110,48735,9195,NA,39541,4057,542,44140,66324
"2190",2000,"Butler",15299,24116,368951,2106,135,0.0338,5.82,132294,31890,27287,4603,129195,14222,13801,7803,18046,65796,4011,8107,63205,-6570,-502,-6727,659,164184,129195,34989,-6570,28419,2007,0,26412,4584,610,31606,66498
"2191",2000,"Calhoun",11088,23425,259738,2354,126,0.0338,5.82,130486,34008,28037,5971,137718,13553,19951,6990,18445,55849,3839,5738,69202,-7365,-417,-7585,637,164494,137718,26776,-7365,19411,2096,0,17315,2724,368,20407,74637
"2192",2000,"Carroll",21382,26868,574484,2066,136,0.0338,5.82,242614,34948,27044,7904,236363,37729,66812,7502,18901,180298,5163,7790,92466,-6752,-1370,-6516,1134,277562,236363,41199,-6752,34447,3658,NA,30790,4435,635,35860,62316
"2193",2000,"Cass",14675,25175,369442,1620,122,0.0338,5.82,109034,28456,25189,3267,109420,9166,21886,5379,12228,57711,3284,4775,52702,-5154,-482,-5120,448,137490,109420,28070,-5154,22916,2707,0,20209,2280,320,22809,51323
"2194",2000,"Cedar",18199,28441,517597,2365,135,0.0338,5.82,120231,38821,32643,6178,123693,8622,13330,7291,17129,51139,4122,6465,66734,-6545,-510,-6567,532,159052,123693,35359,-6545,28814,3177,0,25637,3235,440,29312,69092
"2195",2000,"Cerro Gordo",46389,26928,1249172,2189,121,0.0338,5.82,116508,37152,30196,6956,106338,8161,7627,7939,17780,36847,4199,6368,54264,-7189,-326,-7405,542,153660,106338,47322,-7189,40133,4079,0,36054,3437,489,39980,79661
"2196",2000,"Cherokee",13019,25464,331522,2041,119,0.0338,5.82,137969,29414,23155,6259,137252,16727,27472,6434,15677,86554,3740,5275,61927,-5961,-840,-5775,654,167383,137252,30131,-5961,24170,1937,0,22233,2251,319,24803,51415
"2197",2000,"Chickasaw",13168,24891,327764,1744,111,0.0338,5.82,122612,31045,25324,5721,126018,12825,22702,6759,14504,68806,4263,7561,57404,-5839,-541,-5874,576,153657,126018,27639,-5839,21800,2143,0,19657,4200,615,24472,53806
"2198",2000,"Clarke",9194,20961,192718,956,79,0.0338,5.82,43578,10350,8565,1785,55343,10161,4537,1699,3637,31344,1310,5305,28694,-1440,-536,-1187,283,53928,55343,-1415,-1440,-2855,-160,0,-2695,3202,399,906,12234
"2199",2000,"Clay",17360,27424,476080,2139,119,0.0338,5.82,149742,31674,26343,5331,132049,22209,17014,6862,14474,78899,4094,5896,61500,-6916,-168,-7513,765,181416,132049,49367,-6916,42451,7919,0,34532,3433,456,38421,70843
"2200",2000,"Clayton",18611,24099,448513,1686,134,0.0338,5.82,168000,38359,27642,10717,176107,22928,15545,7038,15238,120793,6220,9716,99422,-4373,-1127,-4052,806,206359,176107,30252,-4373,25879,1457,NA,24423,4826,722,29971,47207
"2201",2000,"Clinton",50120,24615,1233709,1961,158,0.0338,5.82,138852,45905,38355,7550,140329,9180,22495,8293,21673,61766,4492,6884,67312,-7327,-659,-7285,617,184757,140329,44428,-7327,37101,3995,0,33106,2782,413,36301,77086
"2202",2000,"Crawford",16944,23096,391335,1828,127,0.0338,5.82,146677,35370,30143,5227,150820,13563,28845,7776,19002,75882,4209,6515,70910,-7218,-870,-7007,659,182047,150820,31227,-7218,24009,1563,0,22446,2804,381,25631,70795
"2203",2000,"Dallas",41446,30487,1263562,1971,116,0.0338,5.82,96773,30940,23086,7854,103376,7039,9078,6578,14506,31294,3014,7557,55604,-5753,-104,-6095,446,127713,103376,24337,-5753,18584,2250,0,16334,3850,553,20737,65479
"2204",2000,"Davis",8544,19665,168020,1063,95,0.0338,5.82,55161,14234,10379,3855,70792,8433,6345,2548,6024,35678,2001,2509,42932,-1824,-579,-1541,296,69395,70792,-1397,-1824,-3221,-1223,0,-1998,1308,181,-509,19483
"2205",2000,"Decatur",8645,17856,154362,765,79,0.0338,5.82,48535,11223,8423,2800,54206,8333,7043,1640,4570,33533,1956,2345,28319,-1546,-538,-1272,264,59758,54206,5552,-1546,4006,439,0,3567,997,140,4704,15002
"2206",2000,"Delaware",18416,23992,441834,2263,134,0.0338,5.82,194245,42063,33850,8213,195140,26750,28761,7687,17852,140485,6597,8574,98919,-6452,-1140,-6238,926,236308,195140,41168,-6452,34716,2367,NA,32350,4238,681,37269,53760
"2207",2000,"Des Moines",42253,26468,1118348,1773,121,0.0338,5.82,54149,16892,13474,3418,60205,3941,7190,4209,9670,20063,2013,2161,31021,-3212,-273,-3217,278,71041,60205,10836,-3212,7624,1109,0,6515,843,150,7508,34086
"2208",2000,"Dickinson",16460,31388,516642,1975,107,0.0338,5.82,74876,18956,15233,3723,70462,5708,12016,4797,9225,31016,2148,2731,33837,-4249,-258,-4308,317,93832,70462,23370,-4249,19121,2057,0,17064,1054,136,18254,43860
"2209",2000,"Dubuque",89201,26335,2349117,2034,131,0.0338,5.82,177925,32988,24116,8872,160661,20771,28590,4687,12318,144575,5392,7489,81414,-4437,-1512,-3607,682,210913,160661,50252,-4437,45815,1841,NA,43975,3522,584,48081,33350
"2210",2000,"Emmet",10995,24703,271610,2205,112,0.0338,5.82,96904,24033,20756,3277,90020,11504,16337,4673,10378,43906,2472,2835,41821,-5173,-207,-5415,449,120937,90020,30917,-5173,25744,2949,0,22795,1544,214,24553,52998
"2211",2000,"Fayette",22022,21541,474369,1966,126,0.0338,5.82,183635,45659,37619,8040,184159,20345,23384,8576,20989,111067,5861,8764,96240,-7562,-857,-7552,847,229294,184159,45135,-7562,37573,3760,NA,33814,4739,693,39246,72568
"2212",2000,"Floyd",16854,23038,388281,2029,117,0.0338,5.82,114577,28715,24751,3964,119613,8734,12805,7309,16375,47792,4346,8773,61271,-6087,-400,-6219,532,143292,119613,23679,-6087,17592,2356,0,15236,4799,670,20705,66785
"2213",2000,"Franklin",10679,26597,284028,2161,123,0.0338,5.82,163490,36990,30345,6645,166110,29860,26389,7786,19861,85229,4457,7574,70183,-7091,-336,-7728,973,200480,166110,34370,-7091,27279,2303,0,24976,3656,487,29119,78261
"2214",2000,"Fremont",7995,27136,216949,1554,104,0.0338,5.82,74695,24596,19357,5239,74457,2436,4855,5560,13513,14616,2501,4223,41369,-5225,-187,-5362,324,99291,74457,24834,-5225,19609,3148,0,16461,2186,302,18949,60079
"2215",2000,"Greene",10341,23791,246018,2035,118,0.0338,5.82,110672,33162,27116,6046,114584,8100,15019,7313,18622,40121,3202,5545,56783,-6908,-356,-7083,531,143834,114584,29250,-6908,22342,2690,0,19652,2848,379,22879,70551
"2216",2000,"Grundy",12368,27056,334633,2395,144,0.0338,5.82,131458,38367,27565,10802,134505,12748,14269,7969,19738,52775,3932,9076,66773,-7287,-370,-7566,649,169825,134505,35320,-7287,28033,4626,0,23407,4283,574,28264,78683
"2217",2000,"Guthrie",11334,24836,281493,1665,112,0.0338,5.82,97752,23444,19512,3932,108993,16142,14667,4743,10519,52879,3318,6333,53271,-4067,-192,-4427,552,121196,108993,12203,-4067,8136,1063,0,7073,3916,550,11539,44873
"2218",2000,"Hamilton",16423,26404,433637,2467,126,0.0338,5.82,218540,36762,28185,8577,221134,47493,34833,7795,17483,142915,5580,14110,93840,-6410,-257,-7462,1309,255302,221134,34168,-6410,27758,3895,NA,23864,9271,1182,34317,75625
"2219",2000,"Hancock",12109,26829,324870,2214,124,0.0338,5.82,138756,37963,31226,6737,133482,17424,16290,7628,16936,60111,4505,5430,65269,-7422,-193,-7939,710,176719,133482,43237,-7422,35815,5231,0,30584,3047,414,34045,78645
"2220",2000,"Hardin",18807,24783,466087,2208,124,0.0338,5.82,232320,36702,28901,7801,203790,49974,36855,7719,16349,160470,4396,12119,76378,-6899,-1066,-7163,1330,269022,203790,65232,-6899,58333,9272,NA,49062,7354,956,57372,71850
"2221",2000,"Harrison",15685,26111,409553,1700,120,0.0338,5.82,108679,31243,27986,3257,108561,6043,11703,8358,18672,35436,3377,6975,53433,-6671,-491,-6688,508,139922,108561,31361,-6671,24690,1574,0,23116,3440,462,27018,73243
"2222",2000,"Henry",20341,24030,488798,1716,117,0.0338,5.82,71909,22716,18672,4044,82142,9142,7562,4747,10194,35936,2578,3527,44392,-3468,-306,-3564,402,94625,82142,12483,-3468,9015,1314,0,7701,1595,218,9514,35973
"2223",2000,"Howard",9934,24693,245297,1571,100,0.0338,5.82,98581,25559,20854,4705,101442,9784,9059,6123,12952,47422,3560,5582,54382,-5086,-419,-5148,481,124140,101442,22698,-5086,17612,1359,0,16253,2804,397,19454,51159
"2224",2000,"Humboldt",10377,26870,278830,2363,135,0.0338,5.82,92999,30131,23615,6516,88004,6493,7635,5404,13341,28798,2961,3992,48178,-6173,-188,-6389,404,123130,88004,35126,-6173,28953,3294,0,25659,2312,311,28282,64201
"2225",2000,"Ida",7804,25705,200600,2056,133,0.0338,5.82,98187,20720,18893,1827,95347,7527,16046,4942,12701,58324,2645,4139,47347,-4309,-618,-4097,406,118907,95347,23560,-4309,19251,1923,0,17328,2026,284,19638,39863
"2226",2000,"Iowa",15729,30204,475075,1817,123,0.0338,5.82,115222,28459,22771,5688,106741,9166,13432,5487,14350,52039,3963,5972,54371,-4723,-617,-4588,482,143681,106741,36940,-4723,32217,5718,0,26499,3273,607,30379,63183
"2227",2000,"Jackson",20297,22909,464992,1713,135,0.0338,5.82,109871,25931,19103,6828,116480,12856,25738,3534,10248,80902,3993,5063,55048,-3359,-1033,-2803,477,135802,116480,19322,-3359,15963,1056,0,14907,2001,316,17224,28969
"2228",2000,"Jasper",37252,26520,987913,1892,123,0.0338,5.82,143110,37078,29589,7489,135584,14747,15202,8144,19165,70020,4057,6599,67670,-7328,-674,-7341,687,180188,135584,44604,-7328,37276,6135,0,31141,3712,558,35411,73090
"2229",2000,"Jefferson",16189,27060,438074,1327,114,0.0338,5.82,53455,17329,14634,2695,57461,4495,6732,3233,7558,24901,1725,2276,31442,-2860,-285,-2823,248,70784,57461,13323,-2860,10463,1147,0,9316,1147,173,10636,28554
"2230",2000,"Johnson",111455,30276,3374385,2266,122,0.0338,5.82,98944,24980,19482,5498,108352,13464,11440,6101,13497,51893,3701,6450,53699,-4329,-514,-4375,560,123924,108352,15572,-4329,11243,1089,0,10154,3039,420,13613,47051
"2231",2000,"Jones",20259,22610,458066,1854,131,0.0338,5.82,124228,31176,25168,6008,123961,10853,20430,6532,14549,73459,4316,6199,61082,-5315,-744,-5104,533,155404,123961,31443,-5315,26128,3590,0,22538,3463,485,26486,50769
"2232",2000,"Keokuk",11418,23910,273005,1620,129,0.0338,5.82,99174,28063,24434,3629,104141,11029,12048,5795,12363,54363,4330,4143,54433,-4525,-560,-4468,503,127237,104141,23096,-4525,18571,2403,0,16168,2188,306,18662,44811
"2233",2000,"Kossuth",17206,26258,451793,2282,126,0.0338,5.82,257527,62391,52892,9499,246641,26216,38997,14297,32031,113995,7759,10149,117192,-13925,-881,-14251,1207,319918,246641,73277,-13925,59352,5210,NA,54143,5043,684,59870,143532
"2234",2000,"Lee",37931,23956,908659,1567,104,0.0338,5.82,72166,18194,14393,3801,71722,6515,7305,4561,10729,34235,2775,3604,36233,-3397,-388,-3365,356,90360,71722,18638,-3397,15241,2917,0,12324,2148,309,14781,37931
"2235",2000,"Linn",192365,31834,6123754,2357,124,0.0338,5.82,103744,30565,25064,5501,113356,7331,11416,6799,14582,39234,4006,6523,62699,-6011,-469,-6011,469,134309,113356,20953,-6011,14942,2059,0,12883,3129,431,16443,64510
"2236",2000,"Louisa",12174,23926,291270,1979,121,0.0338,5.82,74194,19478,15619,3859,72572,7986,7398,4419,9185,36926,2080,4548,36956,-3203,-285,-3273,355,93672,72572,21100,-3203,17897,3082,0,14815,2557,377,17749,37268
"2237",2000,"Lucas",9369,21874,204942,873,88,0.0338,5.82,29783,9016,7384,1632,35922,3293,4152,1368,3840,18741,1295,1760,20214,-1139,-443,-844,148,38799,35922,2877,-1139,1738,81,0,1657,793,124,2574,11042
"2238",2000,"Lyon",11748,24290,285364,2000,113,0.0338,5.82,248288,34636,25271,9365,224614,37408,61705,8172,15612,178099,5106,8003,88608,-8042,-1447,-7691,1096,282924,224614,58310,-8042,50268,8262,NA,42007,4062,574,46643,70189
"2239",2000,"Madison",14049,25817,362702,1456,104,0.0338,5.82,68478,16821,12690,4131,76119,9848,6853,4103,8744,38722,2179,4250,40142,-2713,-350,-2743,380,85299,76119,9180,-2713,6467,1126,0,5341,2478,356,8175,29756
"2240",2000,"Mahaska",22299,25430,567057,1655,110,0.0338,5.82,142931,31840,26398,5442,140213,21419,25872,6222,14604,94304,3634,6546,61916,-5128,-693,-5158,723,174771,140213,34558,-5128,29430,4339,0,25091,3331,462,28884,48627
"2241",2000,"Marion",32104,27010,867128,1581,110,0.0338,5.82,69298,17474,14906,2568,70136,4823,4998,4401,9439,29400,2387,4665,39423,-3444,-416,-3330,302,86772,70136,16636,-3444,13192,1765,0,11427,2068,278,13773,39898
"2242",2000,"Marshall",39356,25892,1019021,2015,129,0.0338,5.82,114291,33992,26387,7605,130016,8686,12577,8118,19042,44245,4522,10024,67047,-6323,-355,-6546,578,148283,130016,18267,-6323,11944,1952,0,9992,5030,678,15700,70046
"2243",2000,"Mills",14554,30604,445415,1698,120,0.0338,5.82,54407,17498,15331,2167,50154,822,1812,4669,9666,7951,1660,2237,29288,-4217,-138,-4301,222,71905,50154,21751,-4217,17534,1773,0,15761,757,109,16627,46456
"2244",2000,"Mitchell",10868,25115,272953,1987,114,0.0338,5.82,162379,29858,22692,7166,149501,23817,28206,7229,13922,106334,4583,8540,63204,-5962,-810,-5938,786,192237,149501,42736,-5962,36774,4082,0,32692,5184,701,38577,56045
"2245",2000,"Monona",10009,24760,247823,1561,120,0.0338,5.82,102875,31622,26322,5300,101633,5842,14606,7312,16449,37055,2974,5170,49280,-6571,-379,-6647,455,134497,101633,32864,-6571,26293,1980,0,24313,2060,300,26673,65820
"2246",2000,"Monroe",8005,24472,195901,1081,88,0.0338,5.82,44847,8838,7053,1785,49963,3917,6774,2053,4645,30858,1466,3086,28022,-1393,-536,-1037,180,53685,49963,3722,-1393,2329,94,0,2235,1246,164,3645,13989
"2247",2000,"Montgomery",11793,26192,308883,1443,120,0.0338,5.82,87529,21948,15550,6398,80125,7045,13405,6627,9771,42050,2304,6251,34722,-3990,-326,-4041,377,109477,80125,29352,-3990,25362,3601,0,21761,3839,493,26093,45479
"2248",2000,"Muscatine",41791,26358,1101541,2142,121,0.0338,5.82,71137,21768,17900,3868,77162,6544,6862,4953,11659,27679,2730,3403,41011,-3783,-338,-3821,376,92905,77162,15743,-3783,11960,1766,0,10194,1995,263,12452,43458
"2249",2000,"O'Brien",15067,25998,391708,2468,123,0.0338,5.82,192439,36604,28809,7795,178529,27181,36124,8537,16731,108757,5177,6379,78400,-7955,-699,-8174,918,229043,178529,50514,-7955,42559,5026,NA,37534,2589,357,40480,83682
"2250",2000,"Osceola",6985,25537,178378,2112,115,0.0338,5.82,161361,28003,20415,7588,136718,24098,25863,6867,12510,104919,3560,5911,57909,-5380,-451,-5691,762,189364,136718,52646,-5380,47266,9418,0,37848,3455,453,41756,56442
"2251",2000,"Page",16939,24066,407654,1302,96,0.0338,5.82,78608,23655,18502,5153,77945,3784,7834,5459,12299,28964,2332,4723,41514,-4650,-440,-4542,332,102263,77945,24318,-4650,19668,1452,0,18216,1932,255,20403,49644
"2252",2000,"Palo Alto",10135,24704,250377,2133,122,0.0338,5.82,184272,32774,27648,5126,164977,28645,32491,6673,15219,107779,3947,7001,71001,-7098,-443,-7544,889,217046,164977,52069,-7098,44971,5935,NA,39037,3501,455,42993,76493
"2253",2000,"Plymouth",24870,27494,683784,2146,107,0.0338,5.82,261180,42201,32567,9634,247026,35854,57563,10378,23916,179724,6118,10361,102836,-8810,-1563,-8458,1211,303381,247026,56355,-8810,47545,4231,NA,43315,5258,696,49269,81456
"2254",2000,"Pocahontas",8602,24876,213987,2329,118,0.0338,5.82,130844,36988,29952,7036,123148,11421,11377,7837,19444,48195,4398,4929,63742,-7975,-256,-8347,628,167832,123148,44684,-7975,36709,3366,0,33343,2320,300,35963,82649
"2255",2000,"Polk",375627,33348,12526539,2026,125,0.0338,5.82,60999,23140,16858,6282,70394,1868,2550,5518,11002,8984,2346,5895,41215,-4134,-98,-4316,280,84139,70394,13745,-4134,9611,1389,0,8222,3466,464,12152,52015
"2256",2000,"Pottawattamie",88022,26621,2343266,1809,115,0.0338,5.82,170804,48430,40548,7882,175760,9613,30000,10974,26564,64858,5240,6690,86679,-9987,-705,-10015,733,219234,175760,43474,-9987,33487,6423,NA,27065,3141,449,30655,105946
"2257",2000,"Poweshiek",18903,27321,516442,1811,126,0.0338,5.82,104967,26527,23374,3153,102561,8699,8229,6030,13418,46381,3524,6173,56488,-5562,-394,-5632,464,131494,102561,28933,-5562,23371,4482,0,18889,3664,531,23084,58586
"2258",2000,"Ringgold",5465,20933,114398,918,91,0.0338,5.82,53801,14942,11706,3236,59559,7900,5626,2202,5302,35084,2046,3825,32658,-2248,-668,-1854,274,68743,59559,9184,-2248,6936,109,0,6827,2066,270,9163,18717
"2259",2000,"Sac",11481,24371,279808,2206,128,0.0338,5.82,173757,31183,25908,5275,173265,25192,34662,8852,17415,113808,4329,8158,74657,-6014,-907,-5983,876,204940,173265,31675,-6014,25661,2135,NA,23527,4722,624,28873,59949
"2260",2000,"Scott",158614,28796,4567459,3018,154,0.0338,5.82,89485,25629,20409,5220,96143,7912,10045,6237,15218,36558,3416,4533,48782,-4736,-376,-4833,473,115114,96143,18971,-4736,14235,2745,0,11490,2461,342,14293,52927
"2261",2000,"Shelby",13031,25569,333188,1807,120,0.0338,5.82,119629,33514,28711,4803,122487,10756,20430,6798,17441,57900,3701,6444,56917,-6147,-551,-6159,563,153143,122487,30656,-6147,24509,1619,0,22890,3577,518,26985,61729
"2262",2000,"Sioux",31609,24706,780929,2319,128,0.0338,5.82,531919,59107,41140,17967,491246,107426,153330,12585,23998,430026,9355,18956,165596,-10235,-2234,-10661,2660,591026,491246,99780,-10235,89545,11616,NA,77931,11336,1582,90849,101893
"2263",2000,"Story",80152,26035,2086721,2384,127,0.0338,5.82,113705,37272,28302,8970,117158,7264,9922,8246,18928,32455,3815,7739,61244,-7116,-282,-7371,537,150977,117158,33819,-7116,26703,4407,0,22296,3529,535,26360,81250
"2264",2000,"Tama",18084,22912,414346,1965,134,0.0338,5.82,118111,40102,32156,7946,128901,8022,8838,8320,20950,41004,4438,6272,72061,-7173,-503,-7258,588,158213,128901,29312,-7173,22139,2207,0,19932,3068,424,23424,77107
"2265",2000,"Taylor",6976,20932,146024,1051,98,0.0338,5.82,61169,17663,14593,3070,61423,7687,5138,3668,7845,29531,2013,3252,31820,-3011,-255,-3077,321,78832,61423,17409,-3011,14398,276,0,14122,1235,204,15561,31638
"2266",2000,"Union",12281,22428,275443,1108,110,0.0338,5.82,59285,12134,10150,1984,63812,7135,12278,2259,6453,37788,1857,3505,30325,-2469,-628,-2118,277,71419,63812,7607,-2469,5138,299,0,4839,1670,226,6735,21497
"2267",2000,"Van Buren",7793,20253,157834,1173,104,0.0338,5.82,47698,12303,9937,2366,53133,5922,3718,2735,5903,26149,1733,2953,30169,-1946,-372,-1823,249,60001,53133,6868,-1946,4922,661,0,4261,1612,210,6083,21549
"2268",2000,"Wapello",36007,21898,788480,1251,114,0.0338,5.82,42366,13847,12039,1808,50093,2653,4164,3592,7287,16684,1728,2629,28040,-2424,-275,-2363,214,56213,50093,6120,-2424,3696,308,0,3388,982,143,4513,25682
"2269",2000,"Warren",40787,26286,1072113,1589,112,0.0338,5.82,53784,19718,15487,4231,65129,2837,4089,3567,9026,21607,2311,3521,39778,-3094,-417,-2924,247,73502,65129,8373,-3094,5279,479,0,4800,1334,183,6317,32177
"2270",2000,"Washington",20718,28582,592166,2071,129,0.0338,5.82,171354,31668,26188,5480,167567,29032,28743,6942,15224,122313,5188,8294,74144,-4810,-797,-4922,909,203022,167567,35455,-4810,30645,6582,NA,24064,4404,597,29065,49041
"2271",2000,"Wayne",6728,20780,139810,833,90,0.0338,5.82,41951,15428,12626,2802,43266,2090,2331,2915,6673,19088,1858,2401,24998,-2179,-482,-1886,189,57379,43266,14113,-2179,11934,500,0,11434,726,99,12259,22863
"2272",2000,"Webster",40234,24853,999925,2432,126,0.0338,5.82,148455,41952,33234,8718,146429,15261,14863,8978,21917,50780,4171,7210,74029,-8987,-148,-9582,743,190407,146429,43978,-8987,34991,4774,0,30217,3180,419,33816,97675
"2273",2000,"Winnebago",11778,22520,265236,1995,119,0.0338,5.82,86144,27046,22741,4305,91376,8517,5802,5967,13853,30158,3064,3789,50384,-5371,NA,-5819,464,113190,91376,21814,-5371,16443,2899,0,13544,2456,330,16330,55986
"2274",2000,"Winneshiek",21265,24849,528405,1600,112,0.0338,5.82,150636,38736,28529,10207,158916,15447,16328,7570,16351,104010,5186,8102,89932,-5235,-1023,-4886,674,189372,158916,30456,-5235,25221,1139,0,24082,4430,635,29147,46626
"2275",2000,"Woodbury",103786,26186,2717769,1665,120,0.0338,5.82,126406,41678,31468,10210,147159,10794,26519,8847,20492,59311,4335,6771,69401,-6740,-611,-6767,638,168084,147159,20925,-6740,14185,1248,0,12937,3463,475,16875,67095
"2276",2000,"Worth",7894,23032,181812,2005,114,0.0338,5.82,69517,24960,19592,5368,68226,4901,2729,5016,12736,18580,2826,1643,38375,-5076,-165,-5269,358,94477,68226,26251,-5076,21175,1660,0,19515,839,129,20483,50937
"2277",2000,"Wright",14327,28579,409455,2434,128,0.0338,5.82,198100,37885,30998,6887,178674,41384,15099,8446,18052,114381,4395,12709,78589,-7054,-60,-8191,1197,235985,178674,57311,-7054,50257,4031,NA,46227,8268,1001,55496,83719
"2278",2001,"Adair",8132,25996,211402,1264,104,0.0283,3.4,78624,22387,17626,4761,90340,6972,10433,5981,11887,40425,2429,3920,48718,-388,-968,938,-358,101011,90340,10671,-388,10283,1188,0,9095,2181,327,11603,38199
"2279",2001,"Adams",4402,25831,113708,1275,109,0.0283,3.4,45593,13116,11543,1573,43982,4607,5806,2870,6357,23460,1425,2288,20629,-200,-600,605,-205,58709,43982,14727,-200,14527,342,0,14185,841,117,15143,22133
"2280",2001,"Allamakee",14333,24021,344290,1314,106,0.0283,3.4,97239,19155,13004,6151,101632,10813,7912,3503,7265,72957,2849,5599,63691,-1960,-1357,-256,-347,116394,101632,14762,-1960,12802,636,0,12166,3409,495,16070,24282
"2281",2001,"Appanoose",13578,21248,288512,853,86,0.0283,3.4,27823,9115,7449,1666,33450,2237,2071,1628,4313,15020,1188,944,21069,-1219,-954,-142,-123,36938,33450,3488,-1219,2269,86,0,2183,438,70,2691,12803
"2282",2001,"Audubon",6664,27289,181856,1913,123,0.0283,3.4,106306,24731,18365,6366,115088,15554,23654,5653,10473,70488,2718,4928,52108,517,-221,1224,-486,131037,115088,15949,517,16466,1194,0,15272,3116,429,18817,35818
"2283",2001,"Benton",25532,27866,711463,2214,136,0.0283,3.4,137855,39197,31024,8173,138068,11232,13070,8928,21572,56896,4318,7979,70969,1490,-534,2626,-602,177052,138068,38984,1490,40474,4573,0,35901,4332,577,40810,80959
"2284",2001,"Black Hawk",127765,26111,3336080,2459,144,0.0283,3.4,110661,28107,21403,6704,118901,12458,13320,7241,14711,51704,3474,8597,59100,1269,NA,1828,-512,138768,118901,19867,1269,21136,3565,0,17571,5866,806,24243,58957
"2285",2001,"Boone",26249,27935,733261,2373,124,0.0283,3.4,90795,25958,20574,5384,109265,7302,8292,8176,17784,30480,3664,6061,57986,1168,-142,1785,-475,116753,109265,7488,1168,8656,2335,0,6321,4001,528,10850,60315
"2286",2001,"Bremer",23506,27038,635562,2268,120,0.0283,3.4,97085,23558,18675,4883,103877,11201,11090,6042,13877,50938,2948,4886,53833,634,-192,1288,-462,120643,103877,16766,634,17400,1351,0,16049,2527,363,18939,46147
"2287",2001,"Buchanan",20952,24924,522216,2231,134,0.0283,3.4,133578,31212,23749,7463,137635,17325,11485,8552,15439,67051,3918,6730,74186,1027,-244,1896,-625,164790,137635,27155,1027,28182,3437,0,24745,3999,610,29354,66527
"2288",2001,"Buena Vista",20241,25636,518899,2356,125,0.0283,3.4,203017,33614,25846,7768,180358,35224,37258,8820,16564,138506,4746,7672,70074,1896,428,2421,-953,236631,180358,56273,1896,58169,12387,NA,45781,4369,589,50739,64511
"2289",2001,"Butler",15065,25301,381161,2164,138,0.0283,3.4,129792,28366,23511,4855,132173,15902,12909,8595,17440,69897,3721,9215,64391,1170,-164,1957,-623,158158,132173,25985,1170,27155,1940,0,25215,5674,744,31633,59895
"2290",2001,"Calhoun",10918,24376,266132,2398,129,0.0283,3.4,124908,30758,24964,5794,137706,15114,20346,7468,17722,59353,3361,5674,68021,1871,NA,2438,-594,155666,137706,17960,1871,19831,2395,0,17436,3132,423,20991,65555
"2291",2001,"Carroll",21225,28244,599479,2103,133,0.0283,3.4,251614,30849,23774,7075,242575,42355,67062,7882,18318,191312,4694,8179,94085,483,-532,2099,-1084,282463,242575,39888,483,40371,3915,NA,36455,5058,712,42225,60302
"2292",2001,"Cass",14488,25369,367545,1718,120,0.0283,3.4,105586,22492,19253,3239,111444,10473,21132,5904,11904,60394,3142,4815,54074,244,-785,1457,-428,128078,111444,16634,244,16878,2362,0,14516,2596,367,17479,45192
"2293",2001,"Cedar",18126,28833,522636,2516,140,0.0283,3.4,118975,32035,26276,5759,120904,8700,12395,7787,16519,49817,3699,6195,65609,1205,-344,2029,-480,151010,120904,30106,1205,31311,3736,0,27575,3470,478,31523,69158
"2294",2001,"Cerro Gordo",45844,28044,1285657,2252,122,0.0283,3.4,104258,31520,24193,7327,103564,8070,7045,8612,17413,35206,3776,6201,52447,1604,NA,2100,-490,135778,103564,32214,1604,33818,3732,0,30086,3650,538,34274,69052
"2295",2001,"Cherokee",12905,27306,352389,2086,114,0.0283,3.4,139323,29946,23877,6069,133734,18127,26275,6973,15181,85765,3352,4894,58932,929,-594,2132,-609,169269,133734,35535,929,36464,2971,0,33493,2158,310,35961,53558
"2296",2001,"Chickasaw",13192,23699,312643,1821,117,0.0283,3.4,113237,24921,19442,5479,130224,13610,24434,7518,13948,73793,3905,8171,58638,65,-577,1175,-533,138158,130224,7934,65,7999,888,0,7111,4992,741,12844,39444
"2297",2001,"Clarke",9207,21333,196410,1005,84,0.0283,3.4,39480,8772,7180,1592,59049,11630,4047,1860,3615,30832,1187,5734,30976,-704,-433,NA,-277,48252,59049,-10797,-704,-11501,-642,0,-10859,4101,507,-6251,8648
"2298",2001,"Clay",17256,27755,478944,2174,123,0.0283,3.4,145818,28658,23236,5422,139818,27520,17716,7665,14249,89696,3952,6007,62709,1493,142,2130,-779,174476,139818,34658,1493,36151,7354,0,28797,3895,516,33208,56122
"2299",2001,"Clayton",18529,24564,455154,1804,133,0.0283,3.4,167503,32048,21204,10844,177746,23103,15996,7403,14506,125031,5667,9727,101344,-2023,-1369,67,-721,199551,177746,21805,-2023,19782,1082,0,18700,5121,791,24612,42472
"2300",2001,"Clinton",49889,25411,1267735,2076,147,0.0283,3.4,134218,37230,29544,7686,136237,8712,19793,8923,21338,58491,3986,6881,66604,438,-1000,1990,-552,171448,136237,35211,438,35649,3802,0,31847,3020,453,35320,75727
"2301",2001,"Crawford",16960,23855,404575,1883,126,0.0283,3.4,146267,31472,26230,5242,149147,14852,27135,8475,18019,75741,3820,6467,70379,808,-948,2367,-611,177739,149147,28592,808,29400,1960,0,27440,2967,400,30807,70526
"2302",2001,"Dallas",43204,31299,1352241,2028,116,0.0283,3.4,85322,25960,18722,7238,101652,7551,9424,7330,14411,32122,2693,6825,53418,956,-219,1593,-418,111282,101652,9630,956,10586,1378,0,9208,3517,546,13271,53200
"2303",2001,"Davis",8588,18803,161482,1108,88,0.0283,3.4,48956,14081,9887,4194,74092,7615,5800,3075,6203,33781,1762,2351,47286,-1167,-877,NA,-259,63037,74092,-11055,-1167,-12222,-3830,0,-8392,1280,188,-6924,15175
"2304",2001,"Decatur",8669,17939,155513,798,82,0.0283,3.4,41485,11594,8711,2883,53664,7884,6068,1859,4788,30517,1891,2347,28827,-1163,-898,NA,-235,53079,53664,-585,-1163,-1748,-304,0,-1444,1038,148,-258,10968
"2305",2001,"Delaware",18294,24779,453306,2408,136,0.0283,3.4,197830,32180,23922,8258,198802,27012,30316,8662,17310,145423,6059,9024,100419,-522,-866,1183,-839,230010,198802,31208,-522,30686,2118,NA,28567,4846,796,34209,52407
"2306",2001,"Des Moines",41820,27219,1138306,1845,123,0.0283,3.4,45827,15899,12631,3268,56677,3339,5910,4570,9221,16293,1680,1947,30010,514,-231,983,-238,61726,56677,5049,514,5563,868,0,4695,808,159,5662,29534
"2307",2001,"Dickinson",16477,31152,513287,1999,114,0.0283,3.4,63007,16600,12945,3655,66626,5355,9749,5454,8889,28180,1947,2671,32561,554,-322,1159,-283,79607,66626,12981,554,13535,1422,0,12113,1231,157,13501,34827
"2308",2001,"Dubuque",88932,26814,2384634,2177,124,0.0283,3.4,172336,26179,17318,8861,155752,19269,27880,4820,11880,141219,4739,7144,80020,-2605,-1902,-123,-580,198515,155752,42763,-2605,40158,1924,0,38234,3639,636,42509,31117
"2309",2001,"Emmet",10890,24923,271409,2241,118,0.0283,3.4,89964,19852,16628,3224,92497,13226,17737,5229,10116,49279,2306,2776,41107,1092,52,1474,-434,109816,92497,17319,1092,18411,2558,0,15853,1645,234,17732,40685
"2310",2001,"Fayette",21791,22039,480258,2076,128,0.0283,3.4,176290,36652,28614,8038,189036,21552,23408,9379,19987,113332,5234,8793,100683,260,-582,1619,-777,212942,189036,23906,260,24166,2650,0,21516,4970,759,27245,62958
"2311",2001,"Floyd",16660,23971,399357,2091,116,0.0283,3.4,108306,25397,21371,4026,120401,10255,13093,7953,15450,49990,4045,8589,61016,995,-174,1671,-502,133703,120401,13302,995,14297,1967,0,12330,5153,739,18222,58316
"2312",2001,"Franklin",10618,28140,298795,2216,128,0.0283,3.4,157761,33637,26903,6734,164356,27868,27971,8400,18990,90015,4087,7574,69466,1558,202,2193,-837,191398,164356,27042,1558,28600,2708,0,25892,4103,539,30534,67746
"2313",2001,"Fremont",7874,27332,215213,1665,109,0.0283,3.4,68512,22211,16751,5460,70516,2377,3499,6074,13285,13422,2283,3687,39311,1203,-286,1785,-296,90723,70516,20207,1203,21410,3447,0,17963,2018,285,20266,55090
"2314",2001,"Greene",10150,24497,248641,2076,126,0.0283,3.4,102748,28819,22807,6012,112168,9119,15288,7904,18373,42003,2981,5727,52776,1488,-149,2138,-501,131567,112168,19399,1488,20887,2608,0,18279,3240,429,21948,60745
"2315",2001,"Grundy",12319,28578,352051,2450,146,0.0283,3.4,124464,35200,25275,9925,135015,12922,14529,8937,18941,54762,3651,9426,66609,1671,-83,2345,-591,159664,135015,24649,1671,26320,4464,0,21856,4845,654,27355,69702
"2316",2001,"Guthrie",11225,25926,291016,1729,119,0.0283,3.4,95692,21808,17947,3861,112451,17920,16270,5303,10116,57131,3100,6803,52939,207,-382,1114,-525,117500,112451,5049,207,5256,741,0,4515,4404,609,9528,38561
"2317",2001,"Hamilton",16236,26364,428048,2519,133,0.0283,3.4,222339,33343,25311,8032,228142,51566,36794,8459,16538,153060,5298,14978,94509,2076,1111,2197,-1232,255682,228142,27540,2076,29616,4811,NA,24804,10459,1335,36598,69279
"2318",2001,"Hancock",11954,26566,317564,2274,124,0.0283,3.4,126080,31106,24357,6749,133119,19134,17445,8100,15902,63758,4069,5443,63026,1708,285,2081,-658,157186,133119,24067,1708,25775,4426,0,21349,3256,441,25046,62322
"2319",2001,"Hardin",18669,26607,496732,2255,128,0.0283,3.4,243532,32594,24852,7742,213979,56114,40584,8419,15576,179068,4033,13106,76147,1822,1061,2043,-1282,276126,213979,62147,1822,63969,12938,NA,51030,8635,1115,60780,64464
"2320",2001,"Harrison",15592,26277,409717,1789,132,0.0283,3.4,96440,26458,22935,3523,105612,6193,9491,9522,18654,29475,3083,7215,51454,971,-596,2042,-475,122898,105612,17286,971,18257,1154,0,17103,3913,543,21559,66965
"2321",2001,"Henry",20408,24228,494453,1785,115,0.0283,3.4,69099,19934,15675,4259,83037,10202,8395,5054,9347,39470,2297,3361,44381,372,-232,975,-371,89033,83037,5996,372,6368,1000,0,5368,1779,246,7393,29629
"2322",2001,"Howard",9908,24257,240339,1640,104,0.0283,3.4,89332,22150,17129,5021,104235,10877,9208,6626,12273,52008,3194,5839,56218,234,-305,987,-448,111482,104235,7247,234,7481,588,0,6893,3160,462,10515,37324
"2323",2001,"Humboldt",10335,27160,280694,2417,128,0.0283,3.4,82307,26302,19881,6421,85966,7065,7341,5804,12586,31405,2692,4095,46383,1374,NA,1761,-370,108609,85966,22643,1374,24017,3235,0,20782,2561,358,23701,50902
"2324",2001,"Ida",7704,27562,212337,2120,136,0.0283,3.4,105332,21001,19174,1827,94200,8414,14509,5525,12264,58988,2361,4234,46893,667,-574,1623,-382,126333,94200,32133,667,32800,3417,0,29383,2249,320,31952,46344
"2325",2001,"Iowa",15868,30546,484711,1874,125,0.0283,3.4,116734,26871,21033,5838,107585,9283,13371,5984,14073,51524,3728,6387,54759,NA,-815,1217,-441,143605,107585,36020,NA,35981,7659,0,28322,3851,807,32980,65210
"2326",2001,"Jackson",20267,23295,472121,1834,131,0.0283,3.4,106356,23171,16375,6796,115878,13748,24687,3643,9594,78004,3643,5250,55313,-2053,-1693,76,-436,129527,115878,13649,-2053,11596,897,0,10699,2298,361,13358,28352
"2327",2001,"Jasper",37377,27353,1022361,1956,127,0.0283,3.4,138152,32783,25596,7187,134856,16016,14598,8772,18508,69659,3700,6505,66757,791,-660,2089,-638,170935,134856,36079,791,36870,6395,0,30475,3978,634,35087,68493
"2328",2001,"Jefferson",16207,25892,419626,1380,113,0.0283,3.4,43506,16115,13206,2909,58267,4677,6646,3597,7677,24782,1499,2347,31824,-68,-384,547,-231,59621,58267,1354,-68,1286,164,0,1122,1322,206,2650,18724
"2329",2001,"Johnson",113546,30106,3418443,2380,129,0.0283,3.4,100668,25075,19317,5758,110926,14248,11892,6741,13327,53913,3303,6952,54463,68,-520,1107,-519,125743,110926,14817,68,14885,1531,0,13354,3659,508,17521,46755
"2330",2001,"Jones",20254,23121,468290,1985,131,0.0283,3.4,122273,28608,22061,6547,119504,10290,18359,7192,13468,70650,3801,6337,60057,-208,-1010,1266,-464,150881,119504,31377,-208,31169,4254,0,26915,3861,557,31333,51623
"2331",2001,"Keokuk",11369,24603,279708,1683,119,0.0283,3.4,90225,25471,21630,3841,105050,11461,12480,6485,11832,55796,3907,4114,54771,116,-467,1044,-461,115696,105050,10646,116,10762,1464,0,9298,2383,341,12022,34429
"2332",2001,"Kossuth",16912,26446,447259,2337,128,0.0283,3.4,233245,52680,42740,9940,251145,30432,42290,15974,30902,123401,7054,10437,114056,2470,NA,3607,-1159,285925,251145,34780,2470,37250,3659,NA,33590,5801,779,40170,109844
"2333",2001,"Lee",37435,24343,911272,1632,100,0.0283,3.4,66305,16385,12813,3572,69802,6061,6991,5066,10150,33763,2434,3450,35650,146,-394,851,-311,82690,69802,12888,146,13034,2744,0,10290,2214,328,12832,32542
"2334",2001,"Linn",194359,31557,6133297,2498,125,0.0283,3.4,102591,28234,22460,5774,111868,7828,10633,7305,13877,38657,3615,6759,61851,592,-674,1694,-428,130825,111868,18957,592,19549,2868,0,16681,3517,484,20682,63934
"2335",2001,"Louisa",12184,24678,300674,2079,119,0.0283,3.4,66986,18302,14376,3926,71038,8104,7075,4959,8949,34495,1827,4691,35433,592,-83,998,-323,85288,71038,14250,592,14842,2501,0,12341,2839,445,15625,32491
"2336",2001,"Lucas",9386,21546,202231,911,88,0.0283,3.4,26742,8015,6304,1711,36356,3798,4056,1457,3671,18768,1153,1927,20294,-1204,-902,-162,-140,34757,36356,-1599,-1204,-2803,-264,0,-2539,969,155,-1415,7974
"2337",2001,"Lyon",11684,25284,295413,2024,118,0.0283,3.4,249298,32379,22419,9960,234488,42192,64299,8920,14675,189944,4610,8411,91381,-55,-1154,2150,-1051,281677,234488,47189,-55,47134,8159,NA,38974,4577,640,44191,59354
"2338",2001,"Madison",14144,26944,381102,1539,110,0.0283,3.4,66902,15532,10974,4558,74266,9353,6509,4458,8453,39501,1892,4120,39481,-524,-791,599,-332,82434,74266,8168,-524,7644,1455,0,6189,2600,368,9157,27401
"2339",2001,"Mahaska",22407,25377,568627,1721,112,0.0283,3.4,131514,25790,20420,5370,137720,22147,24212,6847,14167,90135,3242,6563,60542,273,-454,1387,-660,157304,137720,19584,273,19857,3092,0,16765,3490,493,20748,41379
"2340",2001,"Marion",32583,25890,843590,1648,112,0.0283,3.4,62807,15898,13465,2433,68808,5256,3969,4589,9029,26649,2048,4829,39088,NA,-517,822,-275,78705,68808,9897,NA,9927,1357,0,8570,2392,326,11288,36158
"2341",2001,"Marshall",39414,27206,1072280,2066,132,0.0283,3.4,115655,31193,24141,7052,134618,9700,13631,9311,18797,48449,4308,10818,68053,1386,-167,2105,-552,146848,134618,12230,1386,13616,2294,0,11322,5995,813,18130,67206
"2342",2001,"Mills",14497,31504,456719,1819,116,0.0283,3.4,49241,16289,13812,2477,47677,534,1327,5431,9605,6968,1460,2234,27086,973,-232,1409,-204,65530,47677,17853,973,18826,1881,0,16945,846,123,17914,42273
"2343",2001,"Mitchell",10736,25369,272359,2049,122,0.0283,3.4,149208,26330,18571,7759,148863,23375,27481,8217,13791,105485,4169,8725,63105,NA,-540,1275,-705,175538,148863,26675,NA,26705,2942,0,23763,5630,781,30174,43723
"2344",2001,"Monona",9860,25838,254758,1627,122,0.0283,3.4,94245,28933,23678,5255,98157,5868,12653,7854,15997,34825,2701,5024,48060,1190,-529,2132,-413,123178,98157,25021,1190,26211,1965,0,24246,2223,340,26809,59420
"2345",2001,"Monroe",7986,24915,198973,1126,88,0.0283,3.4,38328,7432,5907,1525,51264,3748,6578,2346,4735,29687,1344,2876,29637,-1149,-831,-154,-164,45760,51264,-5504,-1149,-6653,-638,0,-6015,1468,188,-4359,8641
"2346",2001,"Montgomery",11509,25939,298529,1546,115,0.0283,3.4,79710,20076,13949,6127,78195,7038,12590,7827,9374,39427,2193,6984,32189,216,-612,1177,-349,99786,78195,21591,216,21807,3407,0,18400,4616,590,23606,40283
"2347",2001,"Muscatine",41760,27953,1167303,2271,126,0.0283,3.4,66150,19362,15703,3659,76321,6963,6142,5576,11450,25719,2410,3473,40307,346,-391,1086,-349,85512,76321,9191,346,9537,1567,0,7970,2120,278,10368,40431
"2348",2001,"O'Brien",14950,27450,410372,2498,123,0.0283,3.4,191637,33410,26085,7325,183015,30405,38461,9282,15817,117889,4824,6208,78018,1708,NA,2594,-872,225047,183015,42032,1708,43740,5778,NA,37961,2726,381,41068,73748
"2349",2001,"Osceola",6963,25170,175256,2137,121,0.0283,3.4,157499,25106,17267,7839,141210,26808,26444,7779,12046,113809,3280,6236,58617,819,-114,1662,-729,182605,141210,41395,819,42214,9600,0,32614,3972,520,37106,43690
"2350",2001,"Page",16822,24360,409782,1394,98,0.0283,3.4,75522,21121,16253,4868,77480,3891,7889,6103,12228,30200,2090,4236,41043,302,-759,1369,-308,96643,77480,19163,302,19465,1474,0,17991,1959,262,20212,45322
"2351",2001,"Palo Alto",10051,24299,244232,2177,123,0.0283,3.4,181201,28470,23093,5377,173934,33858,36625,7152,14225,119755,3533,6665,71876,1474,352,1993,-871,209671,173934,35737,1474,37211,5761,NA,31449,3743,478,35670,61446
"2352",2001,"Plymouth",24847,28191,700457,2213,107,0.0283,3.4,268369,40255,31488,8767,252408,39510,57469,11446,23276,186910,5519,10733,104455,1034,-563,2744,-1147,308624,252408,56216,1034,57250,5610,NA,51639,6027,787,58453,81459
"2353",2001,"Pocahontas",8465,24947,211180,2381,125,0.0283,3.4,118514,31968,25224,6744,122642,12518,11926,8536,19266,53475,4191,5107,61098,1896,102,2387,-593,150482,122642,27840,1896,29736,2964,0,26772,2691,344,29807,65039
"2354",2001,"Polk",380108,34048,12941808,2078,126,0.0283,3.4,56847,20180,13530,6650,72333,1887,2520,6164,10882,9513,2182,6372,42326,779,-144,1184,-261,77027,72333,4694,779,5473,826,0,4647,4088,558,9293,47334
"2355",2001,"Pottawattamie",87953,27395,2409454,1921,122,0.0283,3.4,163308,40488,32824,7664,167389,9952,28833,11829,25576,65286,4777,6327,80095,1362,-1287,3317,-668,203796,167389,36407,1362,37769,7755,0,30014,3144,458,33616,98022
"2356",2001,"Poweshiek",18972,27867,528694,1868,124,0.0283,3.4,100794,24309,21336,2973,102809,9169,7972,6710,13203,46750,2985,6291,56479,514,-658,1600,-428,125103,102809,22294,514,22808,4974,0,17834,3968,597,22399,54044
"2357",2001,"Ringgold",5415,20764,112438,968,93,0.0283,3.4,49706,13203,10775,2428,60781,7819,5746,2505,5262,35466,1837,3870,33742,-928,-785,104,-247,62909,60781,2128,-928,1200,NA,0,1178,2332,311,3821,14240
"2358",2001,"Sac",11403,26700,304461,2246,136,0.0283,3.4,178220,28024,22934,5090,171161,25949,34297,10233,16655,111765,4009,8002,72016,1596,71,2329,-804,206244,171161,35083,1596,36679,3097,0,33582,4884,648,39114,66455
"2359",2001,"Scott",158203,30088,4760053,3233,153,0.0283,3.4,87601,23642,18242,5400,95225,8629,9448,6881,14910,34968,3032,4676,47649,752,-237,1430,-441,111243,95225,16018,752,16770,3509,0,13261,2720,385,16366,52633
"2360",2001,"Shelby",12990,26926,349767,1900,124,0.0283,3.4,117997,29232,24324,4908,118956,11190,19111,7086,16307,54614,3290,7093,54879,1244,-442,2190,-504,147229,118956,28273,1244,29517,1709,0,27808,4351,641,32800,63383
"2361",2001,"Sioux",31952,25611,818333,2368,130,0.0283,3.4,567383,54086,36168,17918,511249,118781,158653,13451,22755,471543,8769,19208,169632,-992,-1599,3151,-2544,621469,511249,110220,-992,109228,15768,NA,93458,12411,1758,107627,95840
"2362",2001,"Story",80260,26738,2146028,2433,129,0.0283,3.4,101131,32479,23737,8742,114004,7179,9003,9159,18255,30528,3490,7329,59589,1376,-188,2051,-487,133610,114004,19606,1376,20982,3457,0,17525,3650,584,21759,70603
"2363",2001,"Tama",18080,23676,428069,2014,134,0.0283,3.4,111758,36789,28645,8144,128597,8267,7779,9343,20461,38373,4059,5793,72895,1014,-657,2213,-542,148547,128597,19950,1014,20964,2374,0,18590,3281,466,22337,73385
"2364",2001,"Taylor",6894,21300,146839,1117,101,0.0283,3.4,54547,16555,13233,3322,63013,7340,4510,4385,8183,29090,1813,3136,33646,NA,-488,745,-294,71102,63013,8089,NA,8052,151,0,7901,1207,229,9337,25457
"2365",2001,"Union",12240,22731,278232,1168,116,0.0283,3.4,57918,11444,9308,2136,69271,8861,13188,2409,6593,39648,1829,3926,32465,-708,-792,365,-281,69362,69271,91,-708,-617,-83,0,-534,2130,287,1883,18270
"2366",2001,"Van Buren",7716,19899,153543,1222,100,0.0283,3.4,41993,11012,8343,2669,55885,6610,3862,3197,5749,27844,1647,3016,31804,-603,-465,101,-239,53005,55885,-2880,-603,-3483,-1116,0,-2367,1736,228,-403,14149
"2367",2001,"Wapello",35947,23458,843234,1302,118,0.0283,3.4,34506,11459,9749,1710,50271,2814,3700,4025,7192,15178,1531,2629,28380,-155,-356,400,-199,45965,50271,-4306,-155,-4461,-832,0,-3629,1008,155,-2466,19328
"2368",2001,"Warren",41080,26799,1100920,1656,110,0.0283,3.4,49449,17131,12894,4237,64814,2674,3968,3828,9267,21438,2007,3453,39617,-338,-716,603,-225,66580,64814,1766,-338,1428,141,0,1287,1417,194,2898,28011
"2369",2001,"Washington",21064,27766,584855,2151,129,0.0283,3.4,172629,28227,23029,5198,172486,30694,30444,7644,14523,128635,4832,8389,75960,692,185,1348,-841,200856,172486,28370,692,29062,6542,0,22520,4771,656,27947,43994
"2370",2001,"Wayne",6655,20270,134897,870,86,0.0283,3.4,34026,14394,11310,3084,44056,2026,1648,3418,6912,18901,1761,2306,25985,-1079,-916,NA,-179,48420,44056,4364,-1079,3285,125,0,3160,820,112,4092,15125
"2371",2001,"Webster",40045,25578,1024282,2484,124,0.0283,3.4,134240,37999,28972,9027,141180,16565,15745,9687,20952,52536,3722,6677,67832,2160,154,2692,-686,172239,141180,31059,2160,33219,5070,0,28149,3137,418,31704,81704
"2372",2001,"Winnebago",11586,23392,271024,2049,118,0.0283,3.4,77676,23386,18714,4672,97004,11055,6796,6635,13361,37463,2748,4385,52024,1152,215,1397,-460,101062,97004,4058,1152,5210,1185,0,4025,3070,418,7513,40213
"2373",2001,"Winneshiek",21258,25113,533844,1692,106,0.0283,3.4,147937,30471,19796,10675,166943,15838,17682,8656,16459,112836,4641,8635,95032,-1974,-1526,176,-624,178408,166943,11465,-1974,9491,511,0,8980,5162,740,14882,35101
"2374",2001,"Woodbury",103129,26724,2756044,1731,119,0.0283,3.4,124807,40307,29941,10366,140891,10997,25417,9408,18857,59436,3816,6487,65909,653,-943,2161,-565,165114,140891,24223,653,24876,2358,0,22518,3672,509,26699,65371
"2375",2001,"Worth",7797,22140,172624,2063,114,0.0283,3.4,55689,22237,16567,5670,68271,4820,2458,5401,12533,18199,2490,1441,39128,862,-140,1326,-324,77926,68271,9655,862,10517,916,0,9601,768,127,10496,37490
"2376",2001,"Wright",14133,29965,423501,2490,129,0.0283,3.4,199410,32250,26180,6070,184425,47046,17303,9536,17233,132348,4055,13445,75807,1990,931,2221,-1162,231660,184425,47235,1990,49225,4065,NA,45159,9080,1112,55351,67062
"2377",2002,"Adair",8059,27270,219771,1333,100,0.0159,1.61,92370,12019,6291,5728,88727,5673,11579,5981,11163,36993,2369,3742,48220,1304,123,430,751,104389,88727,15662,1304,16966,1828,0,15138,2003,307,17448,55377
"2378",2002,"Adams",4370,27188,118813,1245,115,0.0159,1.61,50506,7379,5511,1868,41167,4286,6393,2636,5815,21416,1275,2136,18626,666,NA,222,431,57885,41167,16718,666,17384,431,0,16953,642,91,17686,29090
"2379",2002,"Allamakee",14289,24470,349651,1548,113,0.0159,1.61,92060,16198,9308,6890,102257,9853,8453,3356,6827,61642,2725,5493,65550,579,NA,-202,740,108258,102257,6001,579,6580,356,0,6224,3362,493,10079,30418
"2380",2002,"Appanoose",13420,22297,299227,946,99,0.0159,1.61,26713,8219,5937,2282,32917,2049,1934,1525,4129,12165,1138,935,21207,NA,NA,-295,266,34932,32917,2015,NA,1987,79,0,1908,401,67,2376,14548
"2381",2002,"Audubon",6572,28199,185321,1748,124,0.0159,1.61,109832,15522,7517,8005,112232,14640,24811,5093,8930,61878,2578,4813,51367,1760,100,637,1023,125354,112232,13122,1760,14882,1043,0,13839,3021,427,17287,47954
"2382",2002,"Benton",25829,28484,735721,2665,139,0.0159,1.61,146223,21243,10457,10786,127707,10247,12643,8199,19477,48776,4003,7479,65659,2628,165,1204,1259,167466,127707,39759,2628,42387,5000,0,37387,4058,549,41994,97447
"2383",2002,"Black Hawk",126876,27540,3494141,2783,148,0.0159,1.61,112865,14778,6802,7976,113457,11142,13114,6801,13119,41589,3261,8415,57605,2152,83,1004,1065,127643,113457,14186,2152,16338,2898,0,13440,5706,812,19958,71276
"2384",2002,"Boone",26086,29368,766091,2670,128,0.0159,1.61,106103,11908,5728,6180,104291,6400,9092,7650,16682,28531,3645,5480,55342,2097,68,1019,1010,118011,104291,13720,2097,15817,4502,0,11315,3606,495,15416,77572
"2385",2002,"Bremer",23386,27749,648949,2479,128,0.0159,1.61,105827,11249,5898,5351,102011,11142,11174,5734,12902,41799,2775,4772,53512,1920,146,759,1015,117076,102011,15065,1920,16985,1384,0,15601,2386,351,18338,64028
"2386",2002,"Buchanan",20796,25011,520123,2291,130,0.0159,1.61,139537,18427,8388,10039,132091,16706,10445,8130,13442,53879,3638,6312,73418,2479,88,1054,1337,157964,132091,25873,2479,28352,3531,0,24821,3671,582,29074,85658
"2387",2002,"Buena Vista",20233,26079,527658,2581,135,0.0159,1.61,197333,16017,7369,8648,171825,32694,36335,8450,14969,116565,4576,7525,67276,3920,729,1155,2036,213350,171825,41525,3920,45445,9926,NA,35518,4008,556,40082,80768
"2388",2002,"Butler",14926,25654,382908,2434,140,0.0159,1.61,131918,14419,8138,6281,127984,15588,11243,8205,15911,55948,3597,9731,63709,2482,107,1016,1359,146337,127984,18353,2482,20835,1537,0,19298,5837,781,25916,75970
"2389",2002,"Calhoun",10683,25157,268752,2471,128,0.0159,1.61,138142,13484,8299,5185,133000,14780,21819,6918,16068,54131,3069,5388,64958,2623,98,1245,1280,151626,133000,18626,2623,21249,2503,0,18746,3051,423,22220,84011
"2390",2002,"Carroll",21159,28467,602336,2535,133,0.0159,1.61,255737,13870,6950,6920,244263,41669,73064,7176,16761,178533,4451,8165,92977,3714,272,1049,2393,269607,244263,25344,3714,29058,2428,NA,26628,4925,688,32241,77204
"2391",2002,"Cass",14242,26696,380200,1690,123,0.0159,1.61,114753,11549,7583,3966,113417,10467,24749,5615,10942,60751,3124,4660,53860,1690,161,584,945,126302,113417,12885,1690,14575,2208,0,12367,2526,362,15255,54002
"2392",2002,"Cedar",18150,29311,531999,2919,138,0.0159,1.61,122388,16933,10509,6424,112986,7699,11235,7209,15035,38134,3465,5675,62668,2052,72,981,999,139321,112986,26335,2052,28387,3595,0,24792,3185,454,28431,84254
"2393",2002,"Cerro Gordo",45430,28269,1284266,2619,124,0.0159,1.61,112086,17061,8233,8828,96018,6980,6292,8101,16106,26542,3544,5784,49211,2180,76,1078,1026,129147,96018,33129,2180,35309,4130,0,31179,3357,513,35049,85544
"2394",2002,"Cherokee",12685,28229,358086,2114,126,0.0159,1.61,151526,12683,5819,6864,130208,17261,30636,6550,13877,83643,3131,4368,54385,2410,114,985,1311,164209,130208,34001,2410,36411,2953,0,33458,1764,256,35478,67883
"2395",2002,"Chickasaw",12941,24369,315365,2162,117,0.0159,1.61,118810,12742,7137,5605,127993,12700,25079,7241,12658,61133,3730,8421,58164,1940,71,729,1140,131552,127993,3559,1940,5499,598,0,4901,5076,763,10740,57677
"2396",2002,"Clarke",9213,22154,204101,978,91,0.0159,1.61,42902,6539,4765,1774,60415,11637,4608,1764,3393,30857,1120,5600,32293,551,80,-153,624,49441,60415,-10974,551,-10423,-616,0,-9807,4289,550,-4968,12045
"2397",2002,"Clay",17086,27370,467643,2468,117,0.0159,1.61,147891,13499,7104,6395,140406,29344,18521,7415,13249,82796,3959,5822,62096,3090,384,893,1813,161390,140406,20984,3090,24074,5078,0,18996,3739,508,23243,65095
"2398",2002,"Clayton",18369,25028,459740,1970,143,0.0159,1.61,158689,26063,13409,12654,171501,20416,16232,6747,13023,102699,5387,9374,100322,1710,148,73,1489,184752,171501,13251,1710,14961,796,NA,14164,4749,749,19662,55990
"2399",2002,"Clinton",49659,26236,1302863,2575,152,0.0159,1.61,138814,20123,10818,9305,129141,7172,19344,8324,19844,48591,3691,6728,64038,2228,NA,1050,1142,158937,129141,29796,2228,32024,3361,0,28663,2844,425,31932,90223
"2400",2002,"Crawford",16981,24531,416562,1942,130,0.0159,1.61,155842,12992,7324,5668,143063,14283,26987,8006,16107,63774,3616,6187,67877,2528,88,1131,1309,168834,143063,25771,2528,28299,1901,NA,26397,2678,368,29443,92068
"2401",2002,"Dallas",44960,31777,1428690,2447,115,0.0159,1.61,92173,13940,5873,8067,95375,7120,9420,7074,13523,25677,2508,5927,49803,1779,62,814,903,106113,95375,10738,1779,12517,1672,0,10845,2754,465,14064,66496
"2402",2002,"Davis",8586,19337,166027,1100,94,0.0159,1.61,50196,12954,7542,5412,74965,5869,5974,3180,6026,28244,1617,2163,50136,298,NA,-250,524,63150,74965,-11815,298,-11517,-3018,0,-8499,1077,170,-7252,21952
"2403",2002,"Decatur",8603,18677,160680,823,91,0.0159,1.61,41986,9174,5432,3742,52183,6469,6454,1822,4725,26622,1895,2318,28500,364,NA,-140,485,51160,52183,-1023,364,-659,-57,0,-602,928,135,461,15364
"2404",2002,"Delaware",18271,24530,448193,2299,145,0.0159,1.61,187943,21393,11715,9678,194260,23926,32055,8444,15844,123108,5802,9171,99018,2670,151,760,1759,209336,194260,15076,2670,17746,1260,NA,16485,4865,799,22149,64835
"2405",2002,"Des Moines",41138,27938,1149296,2388,122,0.0159,1.61,47909,8682,4605,4077,50810,2334,4479,4301,8295,9828,1452,1761,28188,901,NA,417,471,56591,50810,5781,901,6682,1106,0,5576,715,145,6436,38081
"2406",2002,"Dickinson",16351,32694,534578,2019,110,0.0159,1.61,76520,8272,4404,3868,65232,4346,12659,5360,8084,32612,1841,2532,30410,1157,NA,554,585,84792,65232,19560,1157,20717,1923,0,18794,1203,157,20154,43908
"2407",2002,"Dubuque",89132,27908,2487465,2570,138,0.0159,1.61,152637,21180,11165,10015,146368,15408,28439,4288,10816,115842,4345,6660,76412,1175,89,-51,1137,173817,146368,27449,1175,28624,1621,NA,27002,3376,599,30977,36795
"2408",2002,"Emmet",10815,26174,283077,2509,118,0.0159,1.61,102529,9629,6391,3238,92674,13285,20911,5066,9312,48860,2238,2603,39259,1950,228,754,968,112158,92674,19484,1950,21434,3046,0,18388,1508,222,20118,53669
"2409",2002,"Fayette",21643,22116,478666,2030,125,0.0159,1.61,177414,21456,12655,8801,186192,20074,23891,8892,17947,95484,4876,8404,102108,2822,214,961,1647,198870,186192,12678,2822,15500,1745,NA,13754,4545,717,19016,81930
"2410",2002,"Floyd",16670,25013,416959,2123,119,0.0159,1.61,115746,12378,7978,4400,115834,10484,13204,7500,13733,41911,3923,7944,59046,2075,76,903,1096,128124,115834,12290,2075,14365,2062,0,12303,4768,713,17784,73835
"2411",2002,"Franklin",10674,27581,294398,2386,130,0.0159,1.61,155032,16092,8790,7302,152426,22458,26900,7859,17129,70788,3909,7364,66807,3063,225,1179,1659,171124,152426,18698,3063,21761,2221,NA,19539,3891,519,23949,84244
"2412",2002,"Fremont",7787,27135,211300,1923,107,0.0159,1.61,63063,13674,6200,7474,64698,2025,3193,5752,12339,12438,2173,3000,36216,1175,NA,535,627,76737,64698,12039,1175,13214,2162,0,11052,1568,229,12849,50625
"2413",2002,"Greene",10105,26005,262784,2408,130,0.0159,1.61,119354,13109,6777,6332,106551,8993,17135,7406,17124,39346,2893,5574,47426,2285,55,1139,1091,132463,106551,25912,2285,28197,3649,0,24548,3117,422,28087,80008
"2414",2002,"Grundy",12372,28557,353307,2862,149,0.0159,1.61,139010,18468,7075,11393,129080,11495,14330,8674,17149,44871,3533,9335,64564,2550,81,1225,1244,157478,129080,28398,2550,30948,5514,0,25434,4654,648,30736,94139
"2415",2002,"Guthrie",11227,27086,304100,1742,119,0.0159,1.61,107325,12822,8288,4534,112278,17452,19578,5136,9181,54261,3019,6791,51121,1935,226,555,1154,120147,112278,7869,1935,9804,1304,0,8500,4223,586,13309,53064
"2416",2002,"Hamilton",16337,26034,425322,2535,130,0.0159,1.61,218563,14040,7756,6284,222013,49193,37266,7959,14745,129249,5230,15145,92475,4673,722,1273,2678,232603,222013,10590,4673,15263,2683,NA,12578,9928,1317,23823,89314
"2417",2002,"Hancock",11846,29112,344857,2239,125,0.0159,1.61,136066,13638,7319,6319,126316,18450,18293,7456,14058,54474,3832,5146,59081,2860,291,1160,1409,149704,126316,23388,2860,26248,4358,0,21890,2968,407,25265,81592
"2418",2002,"Hardin",18476,26059,481464,2219,130,0.0159,1.61,237008,16504,7848,8656,209646,55218,41819,7958,13993,154261,3860,13030,73768,4661,631,1182,2848,253512,209646,43866,4661,48527,11258,NA,37267,8501,1127,46895,82747
"2419",2002,"Harrison",15421,27404,422603,1897,127,0.0159,1.61,111524,12540,7745,4795,100667,5577,9980,9375,17602,25172,2933,7107,48093,2015,NA,968,1025,124064,100667,23397,2015,25412,1681,0,23731,3794,554,28079,86352
"2420",2002,"Henry",20086,25054,503235,2219,123,0.0159,1.61,76424,12053,7453,4600,80470,9981,9407,4666,8043,35637,2137,3124,43112,1260,NA,421,793,88477,80470,8007,1260,9267,1503,0,7764,1693,240,9697,40787
"2421",2002,"Howard",9860,25800,254384,1812,107,0.0159,1.61,104771,13388,7639,5749,102764,10605,9789,6217,10958,48033,2991,5813,56391,1718,70,685,963,118159,102764,15395,1718,17113,1359,0,15754,3063,465,19282,56738
"2422",2002,"Humboldt",10176,28347,288460,2464,130,0.0159,1.61,95550,11126,5700,5426,80643,6752,7268,5403,11186,28601,2551,4139,43344,1793,66,944,783,106676,80643,26033,1793,27826,3801,0,24025,2427,354,26806,66949
"2423",2002,"Ida",7636,28782,219783,2371,143,0.0159,1.61,110472,8084,5940,2144,90095,8247,13817,5348,11179,50245,2198,4177,45129,1676,73,775,828,118556,90095,28461,1676,30137,3213,0,26924,2142,311,29377,60227
"2424",2002,"Iowa",15911,32068,510234,1855,130,0.0159,1.61,133017,16320,8957,7363,104547,8250,13636,5659,13036,41869,3652,6731,53583,1543,52,559,932,149337,104547,44790,1543,46333,12561,0,33772,4174,900,38846,91148
"2425",2002,"Jackson",20142,24094,485298,2033,138,0.0159,1.61,106963,16539,9773,6766,116125,12925,28620,3251,8453,71972,3467,5409,54000,941,58,NA,923,123502,116125,7377,941,8318,729,0,7589,2296,354,10239,34991
"2426",2002,"Jasper",37552,28221,1059764,2027,140,0.0159,1.61,147592,16715,8345,8370,128251,15283,14297,8190,16871,56784,3519,6103,63988,2457,79,1008,1370,164307,128251,36056,2457,38513,6622,0,31891,3747,623,36261,90808
"2427",2002,"Jefferson",16131,25885,417544,1593,118,0.0159,1.61,48370,10982,6958,4024,57069,4276,6966,3465,7361,20923,1360,2348,31293,698,NA,172,496,59352,57069,2283,698,2981,383,0,2598,1325,209,4132,27447
"2428",2002,"Johnson",114948,30696,3528434,2466,127,0.0159,1.61,103806,15057,7613,7444,108410,13260,12355,6454,12431,45195,3076,7176,53658,1729,100,515,1114,118863,108410,10453,1729,12182,1349,0,10833,3719,529,15081,58611
"2429",2002,"Jones",20283,23541,477472,2566,138,0.0159,1.61,118886,17134,8439,8695,112324,8461,18322,6865,11715,59918,3489,6100,57372,1624,50,641,933,136020,112324,23696,1624,25320,3504,0,21816,3703,556,26075,58968
"2430",2002,"Keokuk",11330,25484,288734,1899,119,0.0159,1.61,96763,16139,10899,5240,101155,10471,12595,6283,10682,45263,3679,3899,53546,1486,81,430,975,112902,101155,11747,1486,13233,1729,0,11504,2237,334,14075,51500
"2431",2002,"Kossuth",16670,27960,466087,2557,127,0.0159,1.61,254575,24246,13607,10639,243964,30814,44689,15452,28143,106845,6688,10369,107809,4857,217,2074,2566,278821,243964,34857,4857,39714,3953,NA,35759,5644,767,42170,147730
"2432",2002,"Lee",36960,25434,940028,1758,101,0.0159,1.61,65411,9444,5819,3625,64716,4865,6515,4872,9047,25991,2225,3112,34080,887,NA,215,629,74855,64716,10139,887,11026,2481,0,8545,1977,300,10822,39420
"2433",2002,"Linn",195987,31906,6253102,2686,128,0.0159,1.61,106272,15107,7677,7430,106120,7347,10154,6804,12453,30898,3402,6674,59286,1728,NA,789,905,121379,106120,15259,1728,16987,2594,0,14393,3366,470,18229,75374
"2434",2002,"Louisa",12225,25476,311450,1948,119,0.0159,1.61,68964,11187,6013,5174,65991,7220,6474,4817,8231,25293,1675,4612,32962,1205,53,472,680,80151,65991,14160,1205,15365,2489,0,12876,2759,454,16089,43671
"2435",2002,"Lucas",9360,21838,204400,1097,94,0.0159,1.61,27328,6749,4479,2270,35655,3824,4254,1346,3312,15295,1071,2053,19795,125,NA,-186,306,34077,35655,-1578,125,-1453,-117,0,-1336,1018,164,-154,12033
"2436",2002,"Lyon",11670,23962,279641,2453,124,0.0159,1.61,240029,17299,7064,10235,237304,41679,70040,8441,12988,171287,4343,8349,91464,3503,243,935,2325,257328,237304,20024,3503,23527,4163,NA,19362,4408,622,24392,68742
"2437",2002,"Madison",14312,27617,395249,1592,96,0.0159,1.61,68051,9783,4433,5350,69408,7708,6592,4198,7714,33576,1713,3755,37728,925,145,110,670,77834,69408,8426,925,9351,1716,0,7635,2347,330,10312,34475
"2438",2002,"Mahaska",22394,25161,563448,1754,116,0.0159,1.61,129242,14711,8005,6706,129948,20123,23472,6529,12975,72249,3017,6329,57503,2208,152,662,1394,143953,129948,14005,2208,16213,2555,0,13658,3142,458,17258,56993
"2439",2002,"Marion",32572,26187,852959,1571,116,0.0159,1.61,69290,8170,5459,2711,65299,5030,3523,4147,8147,21253,1829,4963,37660,909,NA,304,580,77460,65299,12161,909,13070,1879,0,11191,2343,330,13864,48037
"2440",2002,"Marshall",39297,28273,1111028,2622,135,0.0159,1.61,132160,15337,7222,8115,133583,9498,14968,9225,17527,43771,4268,11000,67097,2340,68,1057,1215,147497,133583,13914,2340,16254,2953,0,13301,6019,838,20158,88389
"2441",2002,"Mills",14546,33831,492106,1727,108,0.0159,1.61,48816,8534,4915,3619,43492,185,1111,5448,9015,5382,1337,2195,24201,911,NA,474,434,57350,43492,13858,911,14769,1487,0,13282,814,122,14218,43434
"2442",2002,"Mitchell",10822,25799,279192,2347,121,0.0159,1.61,150697,14235,6156,8079,142164,20050,27466,8076,12904,86975,3955,8489,61224,2550,159,929,1462,164932,142164,22768,2550,25318,2471,0,22847,5235,761,28843,63722
"2443",2002,"Monona",9791,26080,255347,1744,127,0.0159,1.61,105547,12622,7059,5563,94208,5169,14035,7313,14690,33198,2557,4921,45523,1787,NA,903,866,118169,94208,23961,1787,25748,2046,0,23702,2089,332,26123,72349
"2444",2002,"Monroe",7887,25847,203854,1043,94,0.0159,1.61,41294,6290,4617,1673,51368,3119,7117,2318,4556,25070,1282,2623,30353,52,NA,-320,344,47584,51368,-3784,52,-3732,-269,0,-3463,1446,187,-1830,16224
"2445",2002,"Montgomery",11313,26294,297466,1697,105,0.0159,1.61,81959,13215,5790,7425,73197,6160,12510,7953,8484,31201,2170,7078,28842,1284,57,481,746,95174,73197,21977,1284,23261,4279,0,18982,4621,606,24209,50758
"2446",2002,"Muscatine",41757,29160,1217625,2332,128,0.0159,1.61,71908,9973,6302,3671,72236,6516,5653,5433,10622,19573,2217,3306,38489,1320,NA,548,749,81881,72236,9645,1320,10965,1876,0,9089,1910,257,11256,52335
"2447",2002,"O'Brien",14808,27153,402079,2670,127,0.0159,1.61,197239,15405,7397,8008,183081,29814,44254,8749,14090,112792,4685,6047,75442,3219,241,1065,1913,212644,183081,29563,3219,32782,4622,NA,28159,2464,355,30978,84447
"2448",2002,"Osceola",6899,24414,168433,2407,123,0.0159,1.61,155253,13574,5708,7866,138032,26160,26254,7619,10945,96910,3150,6268,57636,2770,370,791,1609,168827,138032,30795,2770,33565,7968,NA,25596,3847,518,29961,58343
"2449",2002,"Page",16506,24257,400390,1677,103,0.0159,1.61,69457,12505,6569,5936,74103,3514,8188,5907,11484,25447,1955,3627,39428,1033,NA,349,660,81962,74103,7859,1033,8892,692,0,8200,1688,235,10123,44010
"2450",2002,"Palo Alto",9896,23812,235639,2311,123,0.0159,1.61,181706,14070,7967,6103,173934,34801,39720,6647,12513,105345,3297,6272,70684,3381,413,1004,1964,195776,173934,21842,3381,25223,4320,NA,20902,3377,439,24718,76361
"2451",2002,"Plymouth",24729,28777,711626,2278,117,0.0159,1.61,269536,16928,8431,8497,248004,38219,58543,10938,21392,160996,5195,10661,103056,4212,292,1414,2506,286464,248004,38460,4212,42672,4235,NA,38435,5824,776,45035,108540
"2452",2002,"Pocahontas",8355,26161,218571,2546,126,0.0159,1.61,139459,13107,7078,6029,117436,12051,13172,8060,18033,50957,4153,5142,56825,2698,122,1284,1292,152566,117436,35130,2698,37828,4056,0,33772,2614,340,36726,88502
"2453",2002,"Polk",384355,35807,13762462,2262,127,0.0159,1.61,70337,11338,3714,7624,71519,1672,2823,5961,10166,9051,2116,6585,42196,1208,NA,636,561,81675,71519,10156,1208,11364,1884,0,9480,4075,578,14133,61286
"2454",2002,"Pottawattamie",88447,28821,2549116,2055,124,0.0159,1.61,164231,20524,10829,9695,154488,9055,29320,11056,23240,54819,4539,5788,71490,2720,NA,1287,1405,184755,154488,30267,2720,32987,7094,NA,25892,2713,404,29009,109412
"2455",2002,"Poweshiek",18941,28547,540700,1817,126,0.0159,1.61,109216,10545,7514,3031,99077,8494,8265,6464,12270,39981,2625,6085,54874,1818,178,730,910,119761,99077,20684,1818,22502,5044,0,17458,3734,584,21776,69235
"2456",2002,"Ringgold",5339,20656,110283,884,93,0.0159,1.61,50766,8726,6782,1944,59842,6770,6451,2461,4932,31415,1722,3675,33831,449,52,-117,514,59492,59842,-350,449,99,NA,0,97,2231,312,2640,19351
"2457",2002,"Sac",11119,27250,302988,2494,135,0.0159,1.61,178490,12618,7065,5553,163227,23486,35910,10206,15024,95497,3871,7291,67439,3059,228,1126,1705,191108,163227,27881,3059,30940,2649,NA,28290,4288,589,33167,82993
"2458",2002,"Scott",158086,31358,4957258,3379,158,0.0159,1.61,95240,11837,5887,5950,91020,8267,9833,6581,13797,29970,2805,4528,45209,1790,54,785,951,107077,91020,16057,1790,17847,3851,0,13996,2579,377,16952,65270
"2459",2002,"Shelby",12869,27881,358798,1989,122,0.0159,1.61,122696,13674,7514,6160,112802,10233,20099,6400,14346,46836,3048,7312,51364,2040,70,926,1044,136370,112802,23568,2040,25608,1249,0,24359,4503,678,29540,75860
"2460",2002,"Sioux",32164,26584,855052,2859,135,0.0159,1.61,595524,27931,10711,17220,533705,115264,190148,12466,20339,483533,8558,18218,168712,7872,752,1503,5617,623455,533705,89750,7872,97622,15578,NA,82042,11670,1700,95412,111991
"2461",2002,"Story",81885,27157,2223764,2623,133,0.0159,1.61,119130,16006,6713,9293,106694,6206,8668,8813,16618,24603,3328,6750,56311,2198,NA,1136,1022,135136,106694,28442,2198,30640,4889,0,25751,3327,554,29632,94527
"2462",2002,"Tama",18017,24402,439645,2153,130,0.0159,1.61,128997,20792,10778,10014,123290,7484,7214,9082,18870,29939,3871,5134,71635,2300,NA,1109,1155,149789,123290,26499,2300,28799,3623,0,25176,3021,447,28644,99058
"2463",2002,"Taylor",6813,21558,146878,1347,102,0.0159,1.61,58664,12246,7743,4503,62546,6089,4722,4502,8043,26807,1705,3035,34450,974,120,230,624,70910,62546,8364,974,9338,188,0,9150,1080,224,10454,31857
"2464",2002,"Union",12163,23188,282041,1367,114,0.0159,1.61,61559,7154,4563,2591,73621,9466,15919,2226,6357,37456,1863,4184,33606,756,NA,57,654,68713,73621,-4908,756,-4152,-458,0,-3694,2252,314,-1128,24103
"2465",2002,"Van Buren",7722,20514,158408,1217,101,0.0159,1.61,47300,7560,4394,3166,56427,6469,4425,3220,5289,26069,1629,2917,32478,439,NA,-123,529,54860,56427,-1567,439,-1128,-310,0,-818,1585,216,983,21231
"2466",2002,"Wapello",35796,24138,864028,1639,121,0.0159,1.61,38387,6927,4795,2132,48860,2622,3692,3906,6704,12228,1414,2617,27905,562,NA,118,428,45314,48860,-3546,562,-2984,-503,0,-2481,901,143,-1437,26159
"2467",2002,"Warren",41422,27983,1159128,1930,112,0.0159,1.61,54064,10441,5324,5117,62438,2184,4220,3562,8976,18093,1817,3338,38341,640,NA,146,475,64505,62438,2067,640,2707,271,0,2436,1285,176,3897,35971
"2468",2002,"Washington",21108,28096,593045,2375,130,0.0159,1.61,166206,16374,10376,5998,167336,28531,30164,7294,13065,104077,4691,8034,75557,2688,241,650,1797,182580,167336,15244,2688,17932,4075,NA,13856,4421,631,18908,62129
"2469",2002,"Wayne",6665,21373,142453,1100,99,0.0159,1.61,42196,11374,7430,3944,43461,1712,1331,3452,6751,16890,1735,2281,26199,288,NA,-110,393,53570,43461,10109,288,10397,378,0,10019,787,107,10913,25306
"2470",2002,"Webster",39654,27045,1072451,2471,127,0.0159,1.61,150782,16852,8927,7925,129072,15800,15643,9061,18894,41951,3464,6259,59951,3144,198,1481,1465,167634,129072,38562,3144,41706,5744,0,35962,2615,361,38938,108831
"2471",2002,"Winnebago",11403,24421,278475,2280,117,0.0159,1.61,93256,11557,6812,4745,97871,12188,7844,6390,12165,37333,2571,4585,52128,2126,238,841,1047,104813,97871,6942,2126,9068,2327,0,6741,3199,449,10389,55923
"2472",2002,"Winneshiek",21183,25827,547083,1696,124,0.0159,1.61,148578,23030,11755,11275,167593,14263,18923,8553,15646,97045,4333,8627,97248,1736,93,309,1334,171608,167593,4015,1736,5751,324,0,5427,5137,745,11309,51533
"2473",2002,"Woodbury",102666,27619,2835562,1878,125,0.0159,1.61,142598,21507,9711,11796,134917,9836,30004,8673,16290,58242,3502,5927,60685,2290,NA,1101,1156,164105,134917,29188,2290,31478,2996,0,28482,3337,476,32295,84356
"2474",2002,"Worth",7795,22545,175735,2027,109,0.0159,1.61,67686,9636,5399,4237,65225,4143,2135,5042,11651,13785,2286,1223,38745,1492,NA,792,676,77322,65225,12097,1492,13589,1020,0,12569,614,109,13292,53901
"2475",2002,"Wright",13957,30847,430532,2565,129,0.0159,1.61,209343,13090,8640,4450,178425,46799,18937,9313,15518,120094,3897,12976,70985,4608,739,1270,2599,222433,178425,44008,4608,48616,4362,NA,44252,8354,1083,53689,89249
"2476",2003,"Adair",8050,27255,219403,1487,111,0.0227,1.01,97771,13452,8817,4635,92645,7492,13742,6436,11584,46248,2336,4944,46111,-5572,-957,-4941,326,111223,92645,18578,-5572,13006,1906,0,11100,2873,430,14403,51523
"2477",2003,"Adams",4365,26157,114177,1392,114,0.0227,1.01,53663,8395,6601,1794,45966,5649,7756,3003,5816,25071,1448,2494,19800,-3389,-612,-2966,189,62058,45966,16092,-3389,12703,449,0,12254,1046,164,13464,28592
"2478",2003,"Allamakee",14345,24628,353285,1645,121,0.0227,1.01,98191,17455,11790,5665,102908,12774,9844,3761,7090,68349,2816,6680,59943,-2642,-1198,-1768,324,115646,102908,12738,-2642,10096,610,0,9486,4396,646,14528,29842
"2479",2003,"Appanoose",13522,22556,305003,1090,92,0.0227,1.01,30354,8003,6110,1893,32738,2173,2205,1738,4177,13708,1135,1200,20110,-2776,-800,-2086,110,38357,32738,5619,-2776,2843,126,0,2717,529,84,3330,16646
"2480",2003,"Audubon",6479,28903,187263,1982,129,0.0227,1.01,127534,15889,9592,6297,122470,19619,28268,6173,9540,76735,2758,6370,49742,-5131,-313,-5281,463,143423,122470,20953,-5131,15822,1334,0,14488,4144,585,19217,50799
"2481",2003,"Benton",25946,28284,733847,2777,139,0.0227,1.01,161597,23473,14587,8886,139945,12315,17509,9403,20364,62242,4055,8931,67368,-8184,-574,-8153,543,185070,139945,45125,-8184,36941,5445,0,31496,5245,732,37473,99355
"2482",2003,"Black Hawk",126491,28131,3558270,2967,141,0.0227,1.01,111647,15648,9146,6502,117869,13633,13316,7921,13969,45353,3590,9301,56139,-4188,NA,-4609,467,127295,117869,9426,-4188,5238,1068,0,4170,6657,958,11785,66294
"2483",2003,"Boone",26232,30074,788909,2883,132,0.0227,1.01,120727,16153,10342,5811,107057,7089,9494,8976,17366,31311,3653,7051,53428,-7024,-199,-7257,432,136880,107057,29823,-7024,22799,7589,0,15210,4759,669,20638,89416
"2484",2003,"Bremer",23549,27697,652232,2647,130,0.0227,1.01,102861,13580,9204,4376,105695,13821,11975,6794,13640,45882,2973,5096,51396,-3143,-123,-3465,445,116441,105695,10746,-3143,7603,781,0,6822,2884,425,10131,56979
"2485",2003,"Buchanan",20822,25048,521554,2556,142,0.0227,1.01,148749,19981,11523,8458,147970,22283,13684,9813,15953,66816,4198,7428,74611,-4570,-246,-4951,627,168730,147970,20760,-4570,16190,2416,0,13774,4704,724,19202,81933
"2486",2003,"Buena Vista",20141,25845,520540,2782,137,0.0227,1.01,232922,19370,10835,8535,196551,46977,43822,9865,16105,143811,4506,9047,66229,-6373,725,-8047,949,252292,196551,55741,-6373,49368,12458,NA,36911,5181,732,42824,89111
"2487",2003,"Butler",14939,25337,378509,2536,141,0.0227,1.01,143974,17015,11372,5643,141114,22290,14243,9401,17018,68558,3804,10909,63449,-4518,-97,-5047,626,160989,141114,19875,-4518,15357,1306,0,14051,7034,985,22070,75416
"2488",2003,"Calhoun",10488,25754,270111,2790,131,0.0227,1.01,162688,17113,12490,4623,145874,20758,27288,8396,17177,71426,3554,6461,62240,-8259,-57,-8796,594,179801,145874,33927,-8259,25668,3584,0,22084,3962,560,26606,91262
"2489",2003,"Carroll",21024,28801,605504,2729,142,0.0227,1.01,289812,17278,10677,6601,267463,55506,82005,8463,17106,202427,4671,10372,89340,-8104,-557,-8611,1064,307090,267463,39627,-8104,31523,3183,NA,28341,6645,949,35935,87385
"2490",2003,"Cass",14275,27168,387826,1880,126,0.0227,1.01,124929,13402,9517,3885,114642,12307,24774,6529,11166,65831,3071,5716,51079,-6190,-731,-5857,398,138331,114642,23689,-6190,17499,2825,0,14674,3357,484,18515,59098
"2491",2003,"Cedar",18224,29808,543222,3027,148,0.0227,1.01,142585,19235,12492,6743,123213,10277,14591,8677,16954,48834,3692,7134,61888,-7132,-404,-7191,463,161820,123213,38607,-7132,31475,5024,0,26451,4270,617,31338,93751
"2492",2003,"Cerro Gordo",45412,29225,1327186,2704,135,0.0227,1.01,123008,19865,12040,7825,102158,8421,7041,9845,17747,30514,3623,6277,49204,-5768,NA,-6217,461,142873,102158,40715,-5768,34947,4437,0,30510,3901,591,35002,92494
"2493",2003,"Cherokee",12579,28372,356896,2406,130,0.0227,1.01,177461,17327,9838,7489,143894,23540,35955,7640,14121,99397,3430,5207,54001,-9612,-893,-9307,588,194788,143894,50894,-9612,41282,4246,0,37036,2503,368,39907,78064
"2494",2003,"Chickasaw",12770,24770,316307,2300,123,0.0227,1.01,136636,16275,10839,5436,144050,17344,32082,8115,13898,84854,3985,9945,58681,-4377,-792,-4104,519,152911,144050,8861,-4377,4484,642,0,3842,6143,917,10902,51782
"2495",2003,"Clarke",9282,23124,214641,1116,95,0.0227,1.01,47392,6932,5329,1603,57252,12401,5078,1792,3156,35280,1078,5365,28382,-1918,-517,-1637,236,54324,57252,-2928,-1918,-4846,-289,0,-4557,4490,606,539,12112
"2496",2003,"Clay",16985,29348,498483,2644,124,0.0227,1.01,183628,17760,11877,5883,153633,33405,24935,8777,14303,99335,3797,8742,59674,-7304,107,-8160,749,201388,153633,47755,-7304,40451,9532,NA,30920,5312,734,36966,84293
"2497",2003,"Clayton",18357,25617,470251,2111,140,0.0227,1.01,172334,28865,17777,11088,176634,24952,19919,7944,13924,112824,5290,10268,94337,-4207,-1400,-3448,641,201199,176634,24565,-4207,20358,1545,0,18813,5914,921,25648,59510
"2498",2003,"Clinton",49585,26190,1298633,2701,162,0.0227,1.01,150591,22850,14444,8406,137275,9044,19385,10051,21696,51069,4088,7618,65393,-6657,-843,-6334,520,173441,137275,36166,-6657,29509,3604,0,25905,3883,585,30373,99522
"2499",2003,"Crawford",16953,25158,426501,2192,130,0.0227,1.01,177606,17614,11104,6510,155250,20017,31935,9543,17664,80010,3647,7001,65443,-9127,-870,-8861,604,195220,155250,39970,-9127,30843,2219,0,28624,3664,519,32807,97596
"2500",2003,"Dallas",47118,31911,1503585,2634,122,0.0227,1.01,113477,17095,9071,8024,107150,8879,12851,8099,13836,39378,2668,10410,50407,-6299,-269,-6421,391,130572,107150,23422,-6299,17123,2534,0,14589,5572,822,20983,74099
"2501",2003,"Davis",8534,20146,171924,1225,103,0.0227,1.01,56126,12743,8484,4259,72666,7844,6846,3204,5905,33515,1638,2623,44606,-3105,-1039,-2290,224,68869,72666,-3797,-3105,-6902,-1823,0,-5079,1434,221,-3424,22611
"2502",2003,"Decatur",8575,18833,161497,936,95,0.0227,1.01,46090,9929,5959,3970,52514,7571,7411,1976,4531,29941,1688,2529,26808,-2463,-951,-1708,196,56019,52514,3505,-2463,1042,56,0,986,1226,182,2394,16149
"2503",2003,"Delaware",18190,25107,456699,2576,151,0.0227,1.01,202740,25468,16616,8852,209001,30799,37534,9470,16588,139731,5926,9983,98701,-4170,-1065,-3884,779,228208,209001,19207,-4170,15037,1198,NA,13840,5993,963,20796,63009
"2504",2003,"Des Moines",41047,27898,1145148,2562,129,0.0227,1.01,55589,9840,6007,3833,50922,2720,4393,4873,8813,12254,1533,1980,26610,-4247,-213,-4240,206,65429,50922,14507,-4247,10260,1923,0,8337,906,163,9406,43335
"2505",2003,"Dickinson",16339,34342,561114,2269,116,0.0227,1.01,82856,11202,7628,3574,68408,5671,11272,6135,9040,27172,1962,3442,30886,-5166,-290,-5141,265,94058,68408,25650,-5166,20484,2363,0,18121,1828,247,20196,55684
"2506",2003,"Dubuque",90012,28466,2562312,2722,150,0.0227,1.01,169799,24849,16128,8721,160405,22164,33227,5448,11775,130058,4748,8015,75028,-3569,-1835,-2273,539,194648,160405,34243,-3569,30674,1939,0,28735,4540,752,34027,39741
"2507",2003,"Emmet",10724,27355,293355,2698,122,0.0227,1.01,128408,12025,8966,3059,107966,18695,25305,6193,11008,61886,2381,3565,40819,-5463,-59,-5865,461,140433,107966,32467,-5463,27004,4522,0,22482,2150,312,24944,66522
"2508",2003,"Fayette",21604,22247,480614,2263,138,0.0227,1.01,186191,26608,18003,8605,195242,27046,25256,10306,18871,108616,5160,9997,98606,-5436,-663,-5513,740,212799,195242,17557,-5436,12121,1702,NA,10420,5951,909,17280,77575
"2509",2003,"Floyd",16641,25191,419199,2307,128,0.0227,1.01,119371,15877,11108,4769,120019,12546,14447,8626,14486,46128,3834,8568,57512,-4675,-99,-5046,470,135248,120019,15229,-4675,10554,1788,0,8766,5684,848,15298,73243
"2510",2003,"Franklin",10655,27589,293961,2562,133,0.0227,1.01,186112,19621,12854,6767,174258,32749,32133,9682,18451,91777,4187,9447,67609,-6207,365,-7355,783,205733,174258,31475,-6207,25268,3265,NA,22004,5237,726,27967,94335
"2511",2003,"Fremont",7743,29277,226691,2052,113,0.0227,1.01,83467,16867,10347,6520,64932,2294,3257,6348,12001,13707,2106,3635,35291,-6873,-341,-6783,251,100334,64932,35402,-6873,28529,5345,0,23184,2040,299,25523,69760
"2512",2003,"Greene",9996,27337,273260,2615,135,0.0227,1.01,140940,16976,10822,6154,117039,11359,21272,8991,17801,46872,3047,6346,48223,-8948,-212,-9218,482,157916,117039,40877,-8948,31929,5012,0,26917,3845,539,31301,94068
"2513",2003,"Grundy",12348,29308,361897,3102,155,0.0227,1.01,157189,21780,11471,10309,139092,15700,17420,9651,18070,54253,3698,10607,63946,-8110,-90,-8576,556,178969,139092,39877,-8110,31767,6307,0,25460,5936,840,32236,102936
"2514",2003,"Guthrie",11343,27388,310663,1982,124,0.0227,1.01,123499,14027,10132,3895,120659,19383,22899,6262,10106,69211,3087,8222,50700,-4519,-373,-4626,480,137526,120659,16867,-4519,12348,2210,0,10138,5515,779,16432,54288
"2515",2003,"Hamilton",16366,26902,440277,2881,134,0.0227,1.01,237618,19032,12097,6935,234551,57275,38982,9444,16055,142199,5349,18038,89408,-5650,1144,-7907,1113,256650,234551,22099,-5650,16449,3161,NA,13289,12108,1664,27061,95419
"2516",2003,"Hancock",11905,30677,365211,2441,130,0.0227,1.01,170464,17427,11384,6043,148304,25297,23471,9575,16298,76883,3972,6865,62826,-6739,313,-7715,663,187891,148304,39587,-6739,32848,6971,0,25877,4212,593,30682,93581
"2517",2003,"Hardin",18327,25747,471861,2507,134,0.0227,1.01,261386,20754,12020,8734,232971,68193,44859,9372,15149,171310,4135,14936,76327,-4151,1426,-6797,1220,282140,232971,49169,-4151,45018,10711,NA,34308,10462,1450,46220,90076
"2518",2003,"Harrison",15444,27911,431058,2096,131,0.0227,1.01,120209,15176,10533,4643,99098,5976,9269,9968,17307,25055,2929,7196,46453,-8488,-526,-8379,417,135385,99098,36287,-8488,27799,2217,0,25582,4303,631,30516,95154
"2519",2003,"Henry",20225,25130,508252,2391,125,0.0227,1.01,89585,12600,8824,3776,83908,12660,10745,5069,8616,41792,2226,3791,40801,-4430,-297,-4478,345,102185,83908,18277,-4430,13847,2607,0,11240,2207,318,13765,47793
"2520",2003,"Howard",9808,26421,259134,1945,109,0.0227,1.01,109319,17014,11577,5437,111589,15346,10963,7241,11835,53615,3305,6496,56403,-4378,-318,-4510,450,126333,111589,14744,-4378,10366,991,0,9375,3924,587,13886,55704
"2521",2003,"Humboldt",10154,28679,291209,2669,133,0.0227,1.01,106192,14544,9359,5185,87857,8994,7681,6646,12475,29787,2721,4756,44584,-6221,NA,-6580,362,120736,87857,32879,-6221,26658,3893,0,22765,2876,422,26063,76405
"2522",2003,"Ida",7571,30109,227957,2568,142,0.0227,1.01,126244,11569,8062,3507,97836,10634,16949,6488,12108,57824,2424,5070,44163,-6730,-586,-6518,374,137813,97836,39977,-6730,33247,4287,0,28960,2911,422,32293,68420
"2523",2003,"Iowa",16062,31960,513348,2032,131,0.0227,1.01,147060,18353,11653,6700,113816,11358,16858,6688,13655,52751,3805,7929,53523,-5385,-841,-4965,421,165413,113816,51597,-5385,46212,12636,0,33576,5168,979,39723,94309
"2524",2003,"Jackson",20148,24501,493651,2122,144,0.0227,1.01,117238,18447,12609,5838,117726,13932,31139,3918,8763,80207,3310,6110,50554,-4007,-1776,-2604,373,135685,117726,17959,-4007,13952,1542,0,12410,3156,478,16044,37031
"2525",2003,"Jasper",37703,28311,1067409,2302,137,0.0227,1.01,162014,19398,12268,7130,137780,18624,15548,10207,18583,65291,3833,7003,63982,-7619,-670,-7560,611,181412,137780,43632,-7619,36013,6875,0,29138,4660,736,34534,96723
"2526",2003,"Jefferson",16194,26218,424573,1698,129,0.0227,1.01,61229,13461,9758,3703,58076,5477,8079,3717,7327,27054,1458,2633,29385,-3738,-594,-3356,212,74690,58076,16614,-3738,12876,1910,0,10966,1621,251,12838,34175
"2527",2003,"Johnson",116673,31098,3628289,2698,133,0.0227,1.01,116762,17314,9664,7650,116184,16190,13563,7397,13528,54070,3552,8586,53368,-4810,-458,-4842,490,134076,116184,17892,-4810,13082,1792,0,11290,4851,697,16838,62692
"2528",2003,"Jones",20406,23557,480702,2677,153,0.0227,1.01,132452,20005,12276,7729,122545,11210,22701,7843,13183,68239,3746,7149,56713,-5039,-1032,-4433,426,152457,122545,29912,-5039,24873,4179,0,20694,4596,696,25986,64213
"2529",2003,"Keokuk",11186,25905,289768,2047,121,0.0227,1.01,106081,18797,13729,5068,103922,13468,13253,6790,11390,49716,3491,4460,51070,-4861,-382,-4902,423,124878,103922,20956,-4861,16095,2430,0,13665,2730,405,16800,56365
"2530",2003,"Kossuth",16525,29464,486890,2686,127,0.0227,1.01,305378,31875,22128,9747,267336,40423,50705,17870,30019,131952,7012,12966,108341,-12937,132,-14212,1143,337253,267336,69917,-12937,56980,7098,NA,49883,7666,1071,58620,173426
"2531",2003,"Lee",36627,25855,946981,1982,106,0.0227,1.01,77789,10467,7398,3069,65942,5275,6458,5455,9647,28166,2349,3670,33088,-4478,-414,-4332,268,88256,65942,22314,-4478,17836,4442,0,13394,2469,377,16240,49623
"2532",2003,"Linn",196920,32557,6411172,2926,138,0.0227,1.01,124768,18026,10886,7140,115205,9377,14361,8133,14399,46325,3685,7891,57359,-6302,-973,-5748,419,142794,115205,27589,-6302,21287,3762,0,17525,4536,643,22704,78443
"2533",2003,"Louisa",12230,25651,313716,2168,130,0.0227,1.01,77314,11687,7611,4076,69292,9412,7322,5115,8465,29344,1699,5297,31982,-3291,NA,-3554,294,89001,69292,19709,-3291,16418,3213,0,13205,3425,535,17165,47970
"2534",2003,"Lucas",9384,22588,211963,1199,91,0.0227,1.01,29288,7128,5311,1817,34658,4465,4365,1409,3137,16824,1024,2086,18172,-2010,-755,-1378,123,36416,34658,1758,-2010,-252,NA,0,-232,1176,186,1130,12464
"2535",2003,"Lyon",11702,25734,301145,2634,124,0.0227,1.01,290509,19920,10472,9448,262325,54097,81010,9633,13636,208558,4457,11020,88472,-9240,-1288,-8972,1020,310429,262325,48104,-9240,38864,8061,NA,30804,6572,939,38315,81951
"2536",2003,"Madison",14481,27881,403743,1808,117,0.0227,1.01,76795,10060,5690,4370,71288,9186,7105,4668,7840,41428,1793,4977,35719,-3651,-762,-3171,282,86855,71288,15567,-3651,11916,2692,0,9224,3268,463,12955,35367
"2537",2003,"Mahaska",22156,26166,579737,1954,112,0.0227,1.01,151664,17162,10856,6306,137978,23738,28510,7083,12682,87822,3220,7387,55358,-6655,-423,-6806,574,168826,137978,30848,-6655,24193,4617,0,19576,4123,603,24302,63842
"2538",2003,"Marion",32547,26388,858845,1793,112,0.0227,1.01,71728,10510,7561,2949,65048,5920,4006,4772,8256,22674,1838,5257,34999,-3904,-449,-3700,245,82238,65048,17190,-3904,13286,2193,0,11093,2787,398,14278,49054
"2539",2003,"Marshall",39397,28614,1127325,2846,135,0.0227,1.01,141497,17913,10942,6971,134362,11500,14958,10212,18061,48404,4106,11843,63682,-6547,-257,-6806,516,159410,134362,25048,-6547,18501,3857,0,14644,7295,1037,22976,93093
"2540",2003,"Mills",14621,33892,495541,1907,114,0.0227,1.01,58672,10376,7114,3262,43214,285,1082,5792,8932,5177,1364,2526,23233,-4928,-187,-4923,182,69048,43214,25834,-4928,20906,2601,0,18305,1127,177,19609,53495
"2541",2003,"Mitchell",10830,25428,275389,2409,132,0.0227,1.01,158835,16977,9774,7203,151527,25073,28293,9100,14020,92420,3996,9688,61357,-5284,-408,-5512,636,175812,151527,24285,-5284,19001,2183,0,16818,6296,920,24034,66415
"2542",2003,"Monona",9819,26696,262127,1914,130,0.0227,1.01,128281,15688,10363,5325,100060,5798,17524,8454,15672,40007,2745,5268,44599,-9372,-619,-9130,377,143969,100060,43909,-9372,34537,3143,0,31394,2553,393,34340,88274
"2543",2003,"Monroe",7954,26856,213609,1200,91,0.0227,1.01,41341,8053,6258,1795,48590,3429,6771,2426,4713,25885,1318,2719,27214,-1849,-733,-1258,142,49394,48590,804,-1849,-1045,-84,0,-961,1659,226,924,15456
"2544",2003,"Montgomery",11211,26247,294259,1798,113,0.0227,1.01,84495,13308,7074,6234,73654,7584,10557,7832,8600,31846,2148,8225,28708,-4911,-362,-4856,307,97803,73654,24149,-4911,19238,3785,0,15453,5833,797,22083,52649
"2545",2003,"Muscatine",41654,29383,1223940,2528,143,0.0227,1.01,82125,11645,8297,3348,76665,7901,6447,6110,11297,24078,2313,4049,38548,-4467,-332,-4460,325,93770,76665,17105,-4467,12638,2524,0,10114,2509,354,12977,58047
"2546",2003,"O'Brien",14762,28580,421895,2993,131,0.0227,1.01,259757,18939,11734,7205,208784,40750,57783,10025,15466,150783,4443,7197,73120,-10709,-601,-10975,867,278696,208784,69912,-10709,59203,9508,NA,49696,3379,487,53562,108974
"2547",2003,"Osceola",6888,25456,175343,2561,124,0.0227,1.01,180357,16522,9300,7222,154661,34798,30166,8346,11672,115276,3308,9109,57262,-5659,156,-6530,715,196879,154661,42218,-5659,36559,9763,0,26796,5560,771,33127,65081
"2548",2003,"Page",16356,25467,416536,1772,107,0.0227,1.01,85062,14271,9252,5019,72967,3922,9127,6212,11164,28807,1945,3981,36616,-5940,-782,-5426,268,99333,72967,26366,-5940,20426,1887,0,18539,2147,304,20990,56255
"2549",2003,"Palo Alto",9748,25858,252063,2532,127,0.0227,1.01,224254,19620,12911,6709,194685,44141,44846,8740,14980,127745,3719,8561,69698,-6444,442,-7773,887,243874,194685,49189,-6444,42745,8545,NA,34201,4678,637,39516,96509
"2550",2003,"Plymouth",24858,29323,728911,2564,121,0.0227,1.01,320582,25760,14477,11283,274907,52057,69240,12563,21890,192541,5274,12422,101461,-12442,-604,-12959,1121,346342,274907,71435,-12442,58993,6595,NA,52399,7266,1008,60673,128041
"2551",2003,"Pocahontas",8170,26689,218050,2762,126,0.0227,1.01,157830,18217,12222,5995,125085,15792,15288,9525,19028,57318,3969,6328,55155,-8475,NA,-9040,572,176047,125085,50962,-8475,42487,5686,0,36801,3571,489,40861,100512
"2552",2003,"Polk",388277,36674,14239546,2483,131,0.0227,1.01,80008,13003,5843,7160,75293,2320,3873,7108,11122,12441,2242,7710,40918,-4400,-252,-4406,258,93011,75293,17718,-4400,13318,2484,0,10834,4940,712,16486,67567
"2553",2003,"Pottawattamie",88821,29485,2618863,2242,136,0.0227,1.01,187500,23647,15055,8592,169483,12965,38677,13886,23118,72440,4625,6934,69278,-11525,-1382,-10774,631,211147,169483,41664,-11525,30139,8251,NA,21889,3732,553,26174,115060
"2554",2003,"Poweshiek",19060,28961,552004,2053,132,0.0227,1.01,121343,13789,10758,3031,101618,9975,9214,7195,13100,47876,2665,6953,52516,-6449,-617,-6222,390,135132,101618,33514,-6449,27065,7212,0,19853,4647,720,25220,73467
"2555",2003,"Ringgold",5332,20351,108512,1017,99,0.0227,1.01,53914,9143,7442,1701,61034,8750,7595,2561,4913,35646,1706,3934,31575,-3031,-917,-2334,220,63057,61034,2023,-3031,-1008,NA,0,-963,2619,377,2033,18268
"2556",2003,"Sac",10967,27002,296136,2678,142,0.0227,1.01,207104,17398,10877,6521,193443,37419,46967,11097,15746,127393,4163,9442,68609,-6524,-63,-7283,822,224502,193443,31059,-6524,24535,3065,NA,21471,5939,837,28247,79711
"2557",2003,"Scott",158048,32023,5061223,3697,164,0.0227,1.01,105800,14731,8247,6484,98040,10216,10218,7684,14818,34363,3061,5637,46406,-4329,-247,-4503,421,120531,98040,22491,-4329,18162,4542,0,13620,3504,513,17637,71437
"2558",2003,"Shelby",12819,27166,348247,2227,128,0.0227,1.01,132800,15777,10740,5037,123204,13563,21735,8021,15876,52319,3252,8727,52030,-7919,-441,-7959,481,148577,123204,25373,-7919,17454,1069,0,16385,5752,853,22990,80481
"2559",2003,"Sioux",32318,28177,910619,3072,136,0.0227,1.01,736103,36394,18209,18185,622730,151867,233020,14646,21996,601746,8918,25123,167160,-13554,-3253,-12801,2500,772497,622730,149767,-13554,136213,27727,NA,108488,16127,2361,126976,134357
"2560",2003,"Story",82068,28066,2303336,2873,141,0.0227,1.01,128650,20565,10616,9949,111988,7749,8949,10161,17961,27751,3464,8618,55086,-6527,-197,-6785,455,149215,111988,37227,-6527,30700,5670,0,25030,4305,680,30015,100899
"2561",2003,"Tama",18030,23875,430458,2369,136,0.0227,1.01,133867,22742,14215,8527,128032,9762,9887,10048,19834,38357,3911,6655,67935,-7634,-624,-7517,507,156609,128032,28577,-7634,20943,3156,0,17787,3994,585,22366,95510
"2562",2003,"Taylor",6747,22139,149373,1436,103,0.0227,1.01,71911,12996,9080,3916,68083,8415,6818,4629,7692,38465,1926,4469,34134,-3974,-595,-3648,269,84907,68083,16824,-3974,12850,327,0,12523,2093,348,14964,33446
"2563",2003,"Union",12004,23388,280750,1497,117,0.0227,1.01,65270,8631,6150,2481,74713,11339,16781,2505,5923,43887,1749,4513,31903,-3018,-835,-2449,266,73901,74713,-812,-3018,-3830,-456,0,-3374,2724,386,-264,21383
"2564",2003,"Van Buren",7672,22061,169255,1355,106,0.0227,1.01,59898,9119,6513,2606,58344,9463,5849,3315,5448,31996,1590,3213,29466,-2858,-523,-2574,239,69017,58344,10673,-2858,7815,1424,0,6391,1936,274,8601,27902
"2565",2003,"Wapello",35750,24583,878826,1764,129,0.0227,1.01,42288,8539,6651,1888,48545,3347,4044,3900,6581,13935,1477,2714,26482,-2898,-319,-2757,178,50827,48545,2282,-2898,-616,-105,0,-511,1201,183,873,28353
"2566",2003,"Warren",42187,28452,1200325,2124,118,0.0227,1.01,56610,11425,7009,4416,62021,2886,4634,4017,8539,20622,1844,3542,36559,-3740,-698,-3242,200,68035,62021,6014,-3740,2274,281,0,1993,1628,231,3852,35988
"2567",2003,"Washington",21190,28833,610966,2546,126,0.0227,1.01,187060,20751,14155,6596,177756,37062,31911,7903,13549,120140,4583,9020,73728,-4490,206,-5477,781,207811,177756,30055,-4490,25565,7144,NA,18422,5388,782,24592,66920
"2568",2003,"Wayne",6614,21355,141242,1208,92,0.0227,1.01,45178,12263,8999,3264,44212,2200,2221,3573,6632,18533,1629,2453,25504,-3186,-879,-2470,163,57441,44212,13229,-3186,10043,445,0,9598,1002,154,10754,26645
"2569",2003,"Webster",39377,27358,1077284,2825,132,0.0227,1.01,174820,20017,13387,6630,144154,19953,17174,11003,20655,53379,3833,8091,63445,-9564,160,-10382,658,194837,144154,50683,-9564,41119,6332,0,34787,3830,542,39159,121441
"2570",2003,"Winnebago",11412,25390,289745,2368,121,0.0227,1.01,110996,14387,9881,4506,105762,17411,9793,7238,12471,46598,2706,6509,49634,-5351,259,-6085,475,125383,105762,19621,-5351,14270,4081,0,10189,4557,650,15396,64398
"2571",2003,"Winneshiek",21006,26995,567061,1904,120,0.0227,1.01,157613,27901,17341,10560,168478,18196,20620,8906,15255,106710,4468,10367,90666,-5384,-1518,-4429,563,185514,168478,17036,-5384,11652,771,0,10881,6652,974,18507,50903
"2572",2003,"Woodbury",102039,27852,2842041,2039,127,0.0227,1.01,176653,25133,13971,11162,149837,13393,36600,10214,17516,77147,3581,7262,61271,-10598,-1225,-9897,524,201786,149837,51949,-10598,41351,4507,0,36844,4384,633,41861,99506
"2573",2003,"Worth",7734,23078,178489,2215,112,0.0227,1.01,72393,12372,8528,3844,66821,4387,2620,5974,12191,14770,2449,1597,37603,-5152,-95,-5347,290,84765,66821,17944,-5152,12792,1088,0,11704,817,136,12657,57623
"2574",2003,"Wright",13831,32732,452716,2804,131,0.0227,1.01,256923,16991,12889,4102,209976,58298,24079,10258,16400,155591,4089,16452,80400,-6677,1197,-8986,1112,273914,209976,63938,-6677,57261,6843,NA,50419,11022,1508,62949,101332
"2575",2004,"Adair",8019,31319,251144,1766,114,0.0268,1.37,110742,15723,11064,4659,96878,8177,15223,6584,12348,49069,2831,5959,45756,17629,2366,15235,NA,126465,96878,29587,17629,47216,8364,0,38852,3531,502,42885,61673
"2576",2004,"Adams",4307,31678,136438,1697,121,0.0268,1.37,63655,10365,8283,2082,51927,6158,10072,3217,6009,29059,1913,3005,21553,10293,1279,8998,NA,74020,51927,22093,10293,32386,1660,0,30726,1374,225,32325,34596
"2577",2004,"Allamakee",14324,26605,381096,1789,125,0.0268,1.37,114558,16451,10670,5781,107177,13766,13810,3979,7563,86979,3521,7633,56905,8730,2580,6122,NA,131009,107177,23832,8730,32562,2221,0,30341,4990,705,36036,27579
"2578",2004,"Appanoose",13462,24250,326450,1270,94,0.0268,1.37,31334,7411,5465,1946,33621,1977,2806,1863,4358,14172,1387,1417,19813,7174,1394,5771,NA,38745,33621,5124,7174,12298,624,0,11674,603,93,12370,17162
"2579",2004,"Audubon",6430,35101,225702,2421,133,0.0268,1.37,154406,18614,12462,6152,133170,21627,33300,6923,10409,95021,3522,7468,49921,16391,1650,14700,NA,173020,133170,39850,16391,56241,5615,0,50626,4934,654,56214,59385
"2580",2004,"Benton",26181,30180,790134,3015,145,0.0268,1.37,168096,26562,17468,9094,153511,12537,22337,10128,21840,71604,5006,10365,71298,25113,1767,23300,NA,194658,153511,41147,25113,66260,12202,0,54058,5900,787,60745,96492
"2581",2004,"Black Hawk",126682,29551,3743637,3311,148,0.0268,1.37,130482,19603,13022,6581,124394,14077,15769,8632,15200,56194,4665,9483,56568,17918,839,17039,NA,150085,124394,25691,17918,43609,10090,0,33519,6729,921,41169,74288
"2582",2004,"Boone",26372,31869,840453,3284,135,0.0268,1.37,122537,20696,14042,6654,111354,6728,10162,9835,18561,33756,4477,8147,53444,19947,777,19133,NA,143233,111354,31879,19947,51826,20159,0,31667,5464,727,37858,88781
"2583",2004,"Bremer",23728,30653,727323,3027,127,0.0268,1.37,118757,16160,11716,4444,111869,14422,14873,7498,14759,56727,3802,5407,51108,14653,1027,13588,NA,134917,111869,23048,14653,37701,4782,0,32919,3028,427,36374,62030
"2584",2004,"Buchanan",20910,27394,572815,2976,146,0.0268,1.37,167221,22723,13881,8842,165174,24487,19077,10971,18759,87330,5597,8266,78017,17800,1358,16385,57,189944,165174,24770,17800,42570,7654,0,34916,5241,771,40928,79891
"2585",2004,"Buena Vista",20000,28692,573830,3223,143,0.0268,1.37,266009,25895,15768,10127,217579,54097,52101,10769,17667,172510,5455,10099,67391,24412,2697,21629,86,291904,217579,74325,24412,98737,28721,NA,70017,5832,783,76632,93499
"2586",2004,"Butler",14985,29596,443492,2900,146,0.0268,1.37,179574,21967,15729,6238,155666,25594,19839,10118,18583,91359,4827,11451,65254,20451,1405,18990,56,201541,155666,45875,20451,66326,6435,0,59891,7355,994,68240,88215
"2587",2004,"Calhoun",10382,30097,312471,3302,140,0.0268,1.37,181877,22524,17451,5073,159497,23578,33923,9424,18750,91674,4749,7259,61814,21973,1158,20761,54,204401,159497,44904,21973,66877,11262,0,55615,4482,602,60699,90203
"2588",2004,"Carroll",20936,32748,685621,3054,141,0.0268,1.37,332027,23745,16107,7638,294100,60944,99206,9307,17985,241967,5895,11917,88846,25367,3784,21490,93,355772,294100,61672,25367,87039,10618,NA,76422,7763,1061,85246,90060
"2589",2004,"Cass",14142,30443,430529,2279,132,0.0268,1.37,145575,17594,13011,4583,126155,13041,28756,7535,12443,73456,3939,7088,53353,19711,2139,17539,NA,163169,126155,37014,19711,56725,9181,0,47544,3874,533,51951,72119
"2590",2004,"Cedar",18248,31348,572036,3280,145,0.0268,1.37,142785,20727,12401,8326,134449,11298,17971,9684,19255,57305,4705,8452,63084,19741,1277,18422,NA,163512,134449,29063,19741,48804,10006,0,38798,4959,685,44442,85480
"2591",2004,"Cerro Gordo",44993,31572,1420525,2995,139,0.0268,1.37,125825,24540,15988,8552,110436,8600,9196,11061,19821,39893,4498,6504,50756,18079,795,17243,NA,150365,110436,39929,18079,58008,8074,0,49934,3919,570,54423,85932
"2592",2004,"Cherokee",12510,31524,394369,2890,133,0.0268,1.37,187465,23400,13932,9468,157066,26247,41478,8335,14807,111581,4444,6351,55404,22988,2402,20534,52,210865,157066,53799,22988,76787,9981,0,66806,3045,429,70280,75884
"2593",2004,"Chickasaw",12691,27413,347896,2523,123,0.0268,1.37,161043,18329,11961,6368,157771,19356,37326,8584,15481,102204,5087,10909,61028,16491,2032,14413,NA,179372,157771,21601,16491,38092,6767,0,31325,6460,922,38707,58839
"2594",2004,"Clarke",9307,24788,230703,1327,94,0.0268,1.37,53005,6573,4797,1776,53436,11334,5768,1740,3044,38732,1285,4528,25737,6172,1457,4697,NA,59578,53436,6142,6172,12314,553,0,11761,3930,504,16195,14273
"2595",2004,"Clay",16960,31402,532582,2974,129,0.0268,1.37,195963,21419,14793,6626,164312,32494,31502,9678,15731,113443,4513,11067,59327,20901,1788,19051,62,217382,164312,53070,20901,73971,19928,0,54043,6507,843,61393,82520
"2596",2004,"Clayton",18358,27262,500479,2430,146,0.0268,1.37,186951,29516,17519,11997,185487,25745,26285,8726,15198,131119,6392,11127,92014,15274,3230,11989,55,216467,185487,30980,15274,46254,4822,0,41432,6380,970,48782,55832
"2597",2004,"Clinton",49498,27758,1373961,2939,162,0.0268,1.37,153215,26343,17016,9327,151131,9554,23419,11242,24091,60427,5331,8766,68728,21633,1903,19684,NA,179558,151131,28427,21633,50060,7130,0,42930,4559,668,48157,92788
"2598",2004,"Crawford",16941,28941,490295,2607,134,0.0268,1.37,198144,24530,16055,8475,169640,22705,38729,10576,19659,97514,4488,7999,65484,25558,2473,23031,54,222674,169640,53034,25558,78592,5969,0,72623,4331,589,77543,100630
"2599",2004,"Dallas",50387,34828,1754900,2947,123,0.0268,1.37,130439,21914,12343,9571,118798,9301,15200,8712,14574,50267,3397,15047,52567,18881,816,18032,NA,152353,118798,33555,18881,52436,8385,0,44051,8461,1132,53644,80172
"2600",2004,"Davis",8612,22383,192766,1461,104,0.0268,1.37,62717,11484,7324,4160,73722,8877,8435,3175,6165,37159,2081,3040,41949,8600,1867,6714,NA,74201,73722,479,8600,9079,1804,0,7275,1654,244,9173,25558
"2601",2004,"Decatur",8580,21004,180211,1104,94,0.0268,1.37,52578,11245,6308,4937,54123,7543,9254,2034,4503,32948,1895,2770,26124,7096,1814,5266,NA,63823,54123,9700,7096,16796,1186,0,15610,1400,202,17212,19630
"2602",2004,"Delaware",18066,26982,487454,3059,144,0.0268,1.37,226319,26955,17034,9921,232490,33728,47708,10250,18215,164191,7505,10926,104158,18126,3102,14956,68,253274,232490,20784,18126,38910,3457,NA,35454,6379,1009,42842,62128
"2603",2004,"Des Moines",40562,29528,1197722,2840,131,0.0268,1.37,59871,12197,7802,4395,52499,2699,4684,5200,9573,15638,1942,2306,26095,11113,488,10607,NA,72068,52499,19569,11113,30682,6466,0,24216,999,169,25384,44233
"2604",2004,"Dickinson",16506,36347,599950,2771,122,0.0268,1.37,86244,12346,8303,4043,76511,6140,14362,6598,10205,31635,2500,4427,32279,12103,685,11394,NA,98590,76511,22079,12103,34182,4916,0,29266,2354,302,31922,54609
"2605",2004,"Dubuque",90462,30014,2715099,2949,156,0.0268,1.37,194734,23619,14232,9387,179320,25539,42655,6303,13033,153885,6141,9392,76257,14126,4055,10022,NA,218353,179320,39033,14126,53159,3737,0,49422,5262,838,55522,40849
"2606",2004,"Emmet",10553,28930,305295,3064,124,0.0268,1.37,132428,13901,10389,3512,120815,21261,28738,6987,12909,71308,3031,4377,43512,15067,1439,13586,NA,146329,120815,25514,15067,40581,8525,0,32056,2635,361,35052,61120
"2607",2004,"Fayette",21415,24655,527984,2671,140,0.0268,1.37,213834,29446,19310,10136,208208,29919,30095,11187,20330,133627,6545,11416,98716,21668,2681,18922,65,243280,208208,35072,21668,56740,9879,0,46861,6772,983,54616,80207
"2608",2004,"Floyd",16586,28279,469037,2781,129,0.0268,1.37,131850,19420,13419,6001,126584,12728,17517,9311,15645,55088,4619,8724,58040,16725,889,15796,NA,151270,126584,24686,16725,41411,8249,0,33162,5876,844,39882,76762
"2609",2004,"Franklin",10716,31834,341131,2962,139,0.0268,1.37,227764,25704,18040,7664,200084,38040,43720,10980,20258,133360,5350,11204,70532,22541,1730,20739,72,253468,200084,53384,22541,75925,12675,NA,63251,6110,809,70170,94404
"2610",2004,"Fremont",7655,33248,254513,2342,114,0.0268,1.37,89917,16327,9291,7036,66688,2228,3202,6667,12111,13086,2546,4268,35666,17030,622,16388,NA,106244,66688,39556,17030,56586,12171,0,44415,2307,324,47046,76831
"2611",2004,"Greene",9932,31029,308179,2909,138,0.0268,1.37,150876,23152,15932,7220,132677,12016,30215,10093,19003,62886,3856,7017,50477,21966,1069,20855,NA,174028,132677,41351,21966,63317,12285,0,51032,4130,553,55715,87990
"2612",2004,"Grundy",12383,33207,411202,3493,155,0.0268,1.37,168831,26359,14897,11462,151743,17523,22423,10149,19502,68265,4662,11964,65520,22744,1051,21644,NA,195190,151743,43447,22744,66191,14499,0,51692,6599,885,59176,100566
"2613",2004,"Guthrie",11389,31198,355319,2388,124,0.0268,1.37,140649,16994,12851,4143,127057,18437,25319,7051,11279,79726,3833,9115,52023,15348,1853,13455,NA,157643,127057,30586,15348,45934,10372,0,35562,6271,843,42676,60923
"2614",2004,"Hamilton",16285,30495,496608,3442,138,0.0268,1.37,264106,24915,16091,8824,244511,56811,45044,10432,17774,171882,6642,18367,89441,22248,1717,20439,92,289021,244511,44510,22248,66758,14244,NA,52515,12871,1676,67062,92224
"2615",2004,"Hancock",11838,32798,388259,2986,135,0.0268,1.37,186598,21943,14938,7005,168508,28305,28800,11157,18868,101655,4975,8305,68098,20076,1542,18474,60,208541,168508,40033,20076,60109,17310,0,42799,5139,688,48626,84943
"2616",2004,"Hardin",18164,29825,541750,3080,142,0.0268,1.37,312986,26925,16406,10519,256836,70929,56711,10297,16697,223088,5285,15805,81112,22935,2929,19904,102,339911,256836,83075,22935,106010,26241,NA,79770,11212,1482,92464,89898
"2617",2004,"Harrison",15412,30402,468550,2460,131,0.0268,1.37,118783,18850,13414,5436,100952,5492,10519,10090,17609,27921,3581,7167,46494,20647,1103,19510,NA,137633,100952,36681,20647,57328,5423,0,51905,4201,591,56697,90862
"2618",2004,"Henry",20225,27165,549418,2677,119,0.0268,1.37,98778,14716,10870,3846,88683,13432,13414,5227,9421,51584,2796,4327,40066,12702,1065,11607,NA,113494,88683,24811,12702,37513,8317,0,29196,2501,347,32044,47194
"2619",2004,"Howard",9792,28205,276186,2190,110,0.0268,1.37,122951,17718,11466,6252,122685,17745,14446,7891,13020,68412,4304,7054,58225,13409,1306,12062,NA,140669,122685,17984,13409,31393,3553,0,27840,4373,625,32838,54539
"2620",2004,"Humboldt",10121,31656,320391,3260,129,0.0268,1.37,110093,19326,13316,6010,96763,9874,9717,7529,14055,36642,3470,4803,47315,17114,577,16504,NA,129419,96763,32656,17114,49770,8055,0,41715,2958,414,45087,73451
"2621",2004,"Ida",7457,33317,248446,2935,145,0.0268,1.37,125802,16226,10920,5306,105242,11416,19406,7280,13350,60397,3154,5882,44754,16886,1555,15298,NA,142028,105242,36786,16886,53672,8386,0,45286,3428,469,49183,65405
"2622",2004,"Iowa",16108,33800,544447,2370,135,0.0268,1.37,148179,21174,13692,7482,123876,12742,20451,7366,14666,61392,4783,8723,55145,16085,1744,14304,NA,169353,123876,45477,16085,61562,16717,0,44845,5544,1007,51396,86787
"2623",2004,"Jackson",20146,26207,527961,2427,146,0.0268,1.37,124800,17455,11220,6235,122941,12878,36460,4376,9333,88476,3920,6814,49160,12952,3544,9378,NA,142255,122941,19314,12952,32266,4421,0,27845,3738,542,32125,36324
"2624",2004,"Jasper",37645,29338,1104443,2687,137,0.0268,1.37,179389,24413,16887,7526,147912,19171,17757,11663,20750,74972,4948,7546,66077,24813,1756,23004,53,203802,147912,55890,24813,80703,17235,0,63468,5048,758,69274,104417
"2625",2004,"Jefferson",16298,28112,458168,1916,131,0.0268,1.37,65139,13163,8989,4174,59431,5852,8873,3792,7537,30296,1865,2822,28690,10517,1092,9407,NA,78302,59431,18871,10517,29388,5214,0,24174,1720,260,26154,34843
"2626",2004,"Johnson",118891,32723,3890429,3169,136,0.0268,1.37,129793,19662,10340,9322,125324,16692,15962,7964,14969,66052,4739,9983,55015,14527,1460,13025,NA,149455,125324,24131,14527,38658,6530,0,32128,5504,757,38389,63741
"2627",2004,"Jones",20613,24655,508216,2883,146,0.0268,1.37,132754,22680,14216,8464,133886,12262,27605,8422,14949,73782,4797,7925,57926,15395,2128,13229,NA,155434,133886,21548,15395,36943,7417,0,29526,4938,732,35196,58972
"2628",2004,"Keokuk",11061,28769,318211,2281,126,0.0268,1.37,124522,20736,14812,5924,113362,14836,17447,7171,12762,63359,4235,4978,51933,16270,1715,14519,NA,145258,113362,31896,16270,48166,8484,0,39682,2900,410,42992,61163
"2629",2004,"Kossuth",16437,33320,547687,3119,136,0.0268,1.37,331427,38511,27573,10938,297077,43923,64626,19362,32710,179102,8847,15009,112600,36152,2483,33570,99,369938,297077,72861,36152,109013,17733,NA,91281,9025,1197,101503,152325
"2630",2004,"Lee",36587,27090,991144,2341,111,0.0268,1.37,81998,10778,7554,3224,68793,4904,7406,5765,10510,32774,2976,3964,33268,12120,1186,10911,NA,92776,68793,23983,12120,36103,10129,0,25974,2667,402,29043,49224
"2631",2004,"Linn",198314,33856,6714097,3275,137,0.0268,1.37,130064,21155,12848,8307,124016,9993,17025,9032,16637,53390,4743,9098,57488,19230,2123,17069,NA,151219,124016,27203,19230,46433,9568,0,36865,5305,713,42883,76674
"2632",2004,"Louisa",12115,27733,335984,2579,129,0.0268,1.37,85048,13036,9048,3988,73829,10182,9578,5171,8956,38524,2098,5696,32148,10549,605,9919,NA,98084,73829,24255,10549,34804,8296,0,26508,3712,546,30766,46524
"2633",2004,"Lucas",9508,24184,229937,1358,101,0.0268,1.37,32255,6706,4897,1809,34847,4440,5305,1407,3081,18539,1215,2085,17314,5364,1406,3948,NA,38961,34847,4114,5364,9478,564,0,8914,1168,179,10261,13716
"2634",2004,"Lyon",11692,29763,347989,2938,134,0.0268,1.37,327903,25421,14755,10666,285870,58350,94828,10336,14673,247762,5547,13580,88556,25015,4455,20472,88,353324,285870,67454,25015,92469,22628,NA,69842,8320,1133,79295,80141
"2635",2004,"Madison",14733,30079,443147,2136,108,0.0268,1.37,85145,11360,6926,4434,73001,9290,7307,4905,8213,44389,2260,5901,35125,11202,2008,9170,NA,96505,73001,23504,11202,34706,8908,0,25798,3931,528,30257,40756
"2636",2004,"Mahaska",22240,28572,635450,2362,120,0.0268,1.37,174131,22083,14857,7226,149066,23805,37451,7296,12835,112117,4109,8320,55250,18983,2281,16655,NA,196214,149066,47148,18983,66131,15159,0,50972,4699,657,56328,62014
"2637",2004,"Marion",32618,28174,918970,2136,120,0.0268,1.37,75646,12463,8745,3718,66305,5926,5305,5152,8628,26676,2256,5298,33740,11391,959,10411,NA,88109,66305,21804,11391,33195,6279,0,26916,2879,395,30190,48970
"2638",2004,"Marshall",39711,29660,1177824,3187,140,0.0268,1.37,145110,22786,15370,7416,137689,11780,16137,10694,19142,55491,4889,12429,62618,20045,1118,18884,NA,167896,137689,30207,20045,50252,11816,0,38436,7692,1047,47175,89619
"2639",2004,"Mills",14715,37205,547469,2310,119,0.0268,1.37,64390,11293,7682,3611,44324,342,1093,5862,9151,4548,1691,3051,23134,13973,300,13658,NA,75683,44324,31359,13973,45332,6915,0,38417,1322,213,39952,59842
"2640",2004,"Mitchell",10898,28246,307824,2724,129,0.0268,1.37,174588,20483,12573,7910,163464,26325,33675,9668,15494,109757,4923,10038,63341,16713,2216,14442,55,195071,163464,31607,16713,48320,6587,0,41733,6576,923,49232,64831
"2641",2004,"Monona",9681,29192,282605,2251,136,0.0268,1.37,121052,19074,12889,6185,104772,5566,18690,9160,17080,39281,3515,5557,45204,19541,1127,18382,NA,140126,104772,35354,19541,54895,5559,0,49336,2717,400,52453,81771
"2642",2004,"Monroe",7969,29089,231808,1418,101,0.0268,1.37,43471,7222,4977,2245,47006,3230,6726,2422,5010,24844,1643,2687,25288,5624,1319,4293,NA,50693,47006,3687,5624,9311,558,0,8753,1644,215,10612,18627
"2643",2004,"Montgomery",11191,29205,326831,2103,111,0.0268,1.37,95540,15154,8656,6498,75484,7868,10300,7374,8990,35440,2610,8844,29498,14298,1113,13160,NA,110694,75484,35210,14298,49508,10608,0,38900,6425,830,46155,60100
"2644",2004,"Muscatine",41758,32134,1341856,2976,143,0.0268,1.37,85037,13580,9839,3741,82212,8100,7923,6482,12281,29961,2910,4638,39878,12152,836,11288,NA,98617,82212,16405,12152,28557,6770,0,21787,2858,388,25033,55076
"2645",2004,"O'Brien",14564,31671,461259,3463,138,0.0268,1.37,279483,22759,14785,7974,232336,45503,71881,10791,17225,186640,5237,8370,73329,24279,3184,21018,77,302242,232336,69906,24279,94185,17771,NA,76415,4011,549,80975,92843
"2646",2004,"Osceola",6863,30134,206812,2963,132,0.0268,1.37,210896,19620,11496,8124,171171,38169,37384,8668,12716,145204,4178,11301,58755,17664,1991,15611,62,230516,171171,59345,17664,77009,23316,0,53693,6888,909,61490,65692
"2647",2004,"Page",16227,28775,466930,1994,112,0.0268,1.37,94996,15662,10396,5266,74001,3748,10677,6228,11242,30849,2372,4459,35275,16378,1638,14718,NA,110658,74001,36657,16378,53035,5723,0,47312,2380,322,50014,64147
"2648",2004,"Palo Alto",9753,29595,288640,2937,127,0.0268,1.37,253533,24187,15667,8520,215336,46833,54382,10334,17714,163446,4898,10213,70962,20744,2196,18470,78,277720,215336,62384,20744,83128,20262,NA,62867,5606,726,69199,90087
"2649",2004,"Plymouth",25042,32708,819085,3064,129,0.0268,1.37,363127,35209,19439,15770,307356,57999,89344,13542,23063,245191,6516,13676,103216,32175,4086,27991,98,398336,307356,90980,32175,123155,16457,NA,106699,7893,1052,115644,117936
"2650",2004,"Pocahontas",8003,31095,248856,3210,127,0.0268,1.37,168276,24066,16918,7148,135307,17146,19653,10492,20557,70769,4705,7262,55492,23210,1050,22110,50,192342,135307,57035,23210,80245,13395,0,66850,4224,553,71627,97507
"2651",2004,"Polk",392164,39030,15306331,2893,140,0.0268,1.37,80517,16419,8222,8197,79210,2617,4430,7880,12356,13293,2847,8082,40998,11969,450,11496,NA,96936,79210,17726,11969,29695,6178,0,23517,5209,716,29442,67224
"2652",2004,"Pottawattamie",89762,30654,2751576,2627,132,0.0268,1.37,226400,27843,18457,9386,186683,14897,48759,15945,23767,85557,5727,8075,69513,34056,2857,31144,55,254243,186683,67560,34056,101616,33226,NA,68391,4429,626,73446,140843
"2653",2004,"Poweshiek",19106,31035,592964,2518,136,0.0268,1.37,126203,17507,13880,3627,104482,9966,9876,7571,14285,51433,3295,7380,52109,19747,1714,18000,NA,143710,104482,39228,19747,58975,18413,0,40562,5009,757,46328,74770
"2654",2004,"Ringgold",5335,24375,130038,1202,108,0.0268,1.37,63263,9362,7529,1833,63398,9409,9842,2544,5059,40885,2074,3977,30493,8762,1985,6758,NA,72625,63398,9227,8762,17989,613,0,17376,2658,371,20405,22378
"2655",2004,"Sac",10871,32542,353761,3112,138,0.0268,1.37,252667,22974,14384,8590,222809,45595,60465,11449,16920,164154,5332,11277,71771,22594,2328,20190,76,275641,222809,52832,22594,75426,13235,NA,62192,7104,951,70247,88513
"2656",2004,"Scott",158145,34544,5463012,4167,163,0.0268,1.37,107169,19193,10999,8194,106420,10629,11548,8389,16233,40847,3957,6639,49025,13746,963,12746,NA,126362,106420,19942,13746,33688,9988,0,23700,4121,572,28393,66322
"2657",2004,"Shelby",12750,30386,387425,2614,131,0.0268,1.37,152281,19417,14302,5115,136957,14841,26957,9201,17787,64257,4146,9724,54301,21783,1398,20342,NA,171698,136957,34741,21783,56524,4313,0,52211,6403,896,59510,88024
"2658",2004,"Sioux",32547,29567,962310,3434,133,0.0268,1.37,817383,40185,17633,22552,689073,165510,270145,16058,24222,688851,11210,30852,171076,39957,10819,28921,217,857568,689073,168495,39957,208452,53939,NA,154515,19209,2688,176412,128532
"2659",2004,"Story",82754,29882,2472838,3362,141,0.0268,1.37,135123,27296,14854,12442,120282,8125,10414,10989,19772,33781,4351,10879,55752,20444,674,19730,NA,162419,120282,42137,20444,62581,13410,0,49171,4845,728,54744,101342
"2660",2004,"Tama",18167,27707,503350,2760,143,0.0268,1.37,153361,26795,17796,8999,135711,10567,13706,10520,21362,47733,4819,7910,66827,23502,1371,22087,NA,180156,135711,44445,23502,67947,12204,0,55743,4593,634,60970,105628
"2661",2004,"Taylor",6689,26555,177626,1629,113,0.0268,1.37,87591,13854,9646,4208,74612,9461,9294,4545,7628,48872,2538,6122,35024,11380,1727,9630,NA,101445,74612,26833,11380,38213,1243,0,36970,3097,460,40527,38719
"2662",2004,"Union",12085,26272,317493,1684,126,0.0268,1.37,76700,9918,7037,2881,76806,11515,18769,2657,5724,50326,2045,4671,31425,8915,1688,7205,NA,86618,76806,9812,8915,18727,1662,0,17065,2867,387,20319,26374
"2663",2004,"Van Buren",7665,24475,187602,1614,111,0.0268,1.37,73589,8560,5893,2667,61914,11012,8856,3259,5773,43236,1913,3367,27734,8347,1277,7049,NA,82149,61914,20235,8347,28582,7023,0,21559,2054,279,23892,30353
"2664",2004,"Wapello",35709,26246,937229,1969,131,0.0268,1.37,51790,8935,6871,2064,50510,3567,5677,3723,6687,18467,1861,2936,26059,9321,916,8390,NA,60725,50510,10215,9321,19536,2516,0,17020,1389,200,18609,33323
"2665",2004,"Warren",42584,31124,1325387,2395,123,0.0268,1.37,61962,11595,6882,4713,63263,3150,5212,4269,8424,21204,2279,3901,36028,10966,1274,9675,NA,73557,63263,10294,10966,21260,3084,0,18176,1793,246,20215,40758
"2666",2004,"Washington",21258,31355,666548,2915,133,0.0268,1.37,224800,24200,15821,8379,191835,39996,39456,8132,14434,158741,5517,9855,74445,17252,2197,14988,67,249000,191835,57165,17252,74417,25741,0,48676,5708,793,55177,66059
"2667",2004,"Wayne",6561,23811,156227,1312,94,0.0268,1.37,46604,11399,8050,3349,46074,2356,3126,3530,6744,17612,1905,2650,25763,8705,1422,7270,NA,58003,46074,11929,8705,20634,1122,0,19512,1078,182,20772,28992
"2668",2004,"Webster",38922,28787,1120439,3394,133,0.0268,1.37,182697,26454,19578,6876,158303,21103,18761,12353,22934,66262,4993,9553,68606,25859,959,24842,58,209151,158303,50848,25859,76707,13993,0,62714,4784,644,68142,116435
"2669",2004,"Winnebago",11321,27614,312614,2725,120,0.0268,1.37,115588,17487,12288,5199,113656,19980,12293,7722,13159,57804,3422,7994,49086,14644,1043,13559,NA,133075,113656,19419,14644,34063,11359,0,22704,5573,756,29033,57784
"2670",2004,"Winneshiek",21040,30335,638238,2269,129,0.0268,1.37,173522,28156,16102,12054,174019,19386,25314,8849,15405,125343,5578,11829,87658,15750,3323,12380,NA,201678,174019,27659,15750,43409,3405,0,40004,7482,1050,48536,48179
"2671",2004,"Woodbury",101816,28893,2941721,2395,130,0.0268,1.37,178630,30947,18101,12846,162418,14918,40342,11220,19206,86302,4447,8371,63914,24595,2446,22103,NA,209577,162418,47159,24595,71754,9079,0,62675,5002,690,68367,92328
"2672",2004,"Worth",7731,25836,199739,2708,116,0.0268,1.37,68024,14157,9877,4280,69882,3984,3241,6591,13083,16042,3130,2000,37853,12481,343,12113,NA,82181,69882,12299,12481,24780,2492,0,22288,936,150,23374,51982
"2673",2004,"Wright",13808,35721,493236,3358,135,0.0268,1.37,290977,22370,17747,4623,234894,61035,30219,10698,17742,197781,5162,18806,91232,24584,2614,21876,94,313347,234894,78453,24584,103037,16344,NA,86694,12636,1657,100987,93196
"2674",2005,"Adair",7932,29199,231607,2020,113,0.0339,3.15,98955,23350,19404,3946,104399,8658,17374,6709,13002,46220,3321,5402,49933,4365,2587,988,790,122305,104399,17906,4365,22271,3679,0,18592,3202,487,22281,52735
"2675",2005,"Adams",4226,29062,122817,1952,127,0.0339,3.15,64665,15261,13249,2012,61688,6513,15019,3407,6160,33678,2381,2755,25453,2973,1827,680,466,79926,61688,18238,2973,21211,1042,0,20169,1300,262,21731,30987
"2676",2005,"Allamakee",14371,27272,391928,1978,121,0.0339,3.15,124224,20912,15932,4980,116767,14440,19606,4170,7968,96025,4223,6800,59560,4015,3405,-187,797,145136,116767,28369,4015,32384,1717,0,30667,4219,644,35530,28199
"2677",2005,"Appanoose",13453,23942,322092,1455,100,0.0339,3.15,31838,9410,7716,1694,36721,1791,4149,1974,4506,15991,1637,1280,21384,2260,1956,58,246,41248,36721,4527,2260,6787,264,0,6523,515,92,7130,15847
"2678",2005,"Audubon",6324,34846,220367,2824,131,0.0339,3.15,170319,26277,21222,5055,152483,23060,44901,7591,11171,111072,4286,6540,54934,4554,1984,1379,1191,196596,152483,44113,4554,48667,4236,0,44431,4345,593,49369,59247
"2679",2005,"Benton",26265,30372,797723,3314,151,0.0339,3.15,172729,41094,33264,7830,175590,12582,31609,10770,23115,78076,5949,9711,81854,5428,1961,2163,1304,213823,175590,38233,5428,43661,7252,0,36409,4925,690,42024,94653
"2680",2005,"Black Hawk",127021,30265,3844255,3636,157,0.0339,3.15,139304,32195,26579,5616,135878,14289,20547,9263,16279,62931,5740,7700,62060,3630,914,1569,1147,171499,135878,35621,3630,39251,7407,0,31844,5040,729,37613,76373
"2681",2005,"Boone",26500,31842,843823,3597,140,0.0339,3.15,125277,30981,24664,6317,121005,6348,13423,10597,19587,37350,5294,7195,58561,3806,960,1822,1024,156258,121005,35253,3806,39059,12815,0,26244,4655,650,31549,87927
"2682",2005,"Bremer",23833,31458,749738,3345,146,0.0339,3.15,126999,28113,24296,3817,122944,14762,19542,8123,15734,61413,4629,4565,55589,3572,1215,1264,1093,155112,122944,32168,3572,35740,3996,0,31744,2372,361,34477,65586
"2683",2005,"Buchanan",20831,28045,584199,3289,147,0.0339,3.15,191292,39184,31427,7757,191126,26052,28848,12005,21293,103693,7002,7205,88721,4768,1610,1473,1685,230476,191126,39350,4768,44118,6560,0,37558,4375,684,42617,87599
"2684",2005,"Buena Vista",19970,28242,563990,3555,140,0.0339,3.15,276073,38437,28582,9855,246355,59441,66717,11572,19043,183738,6394,8534,74654,6466,1931,2004,2531,314510,246355,68155,6466,74621,17728,0,56893,4880,687,62460,92335
"2685",2005,"Butler",14965,30028,449366,3191,155,0.0339,3.15,200808,34786,29025,5761,177912,28068,30536,10754,19957,111843,5846,9232,73519,5168,1825,1696,1647,235594,177912,57682,5168,62850,4961,0,57889,5695,835,64419,88965
"2686",2005,"Calhoun",10228,30751,314518,3626,133,0.0339,3.15,202409,34085,29427,4658,184280,25671,48675,10342,20130,111470,5948,6225,67289,4931,1308,2045,1578,236494,184280,52214,4931,57145,8110,0,49035,3766,531,53332,90939
"2687",2005,"Carroll",20973,32199,675311,3307,152,0.0339,3.15,360322,35220,27905,7315,346637,64798,138722,10058,18717,276668,7117,10543,96682,9004,4541,1792,2671,395542,346637,48905,9004,57909,6217,NA,51693,6721,980,59394,83654
"2688",2005,"Cass",14002,30811,431412,2610,128,0.0339,3.15,143132,26618,22170,4448,131519,12168,34626,7621,12214,79972,4351,6075,54464,4981,2695,1365,921,169750,131519,38231,4981,43212,5400,0,37812,3321,485,41618,63160
"2689",2005,"Cedar",18213,30804,561025,3667,150,0.0339,3.15,136560,37306,28959,8347,154693,12025,26718,10581,21315,68205,5715,7878,70461,4247,1661,1357,1229,173866,154693,19173,4247,23420,4512,0,18908,4274,637,23819,68355
"2690",2005,"Cerro Gordo",44741,32790,1467038,3302,138,0.0339,3.15,139125,38762,30955,7807,123534,8652,13011,12146,21667,46775,5367,5495,57196,3773,941,1659,1173,177887,123534,54353,3773,58126,6290,0,51836,2929,459,55224,92350
"2691",2005,"Cherokee",12380,31224,386553,3186,139,0.0339,3.15,214659,35489,25858,9631,189590,28215,63344,8952,15376,138515,5458,6074,62171,7052,3564,1994,1494,250148,189590,60558,7052,67610,7915,0,59695,2731,412,62838,76144
"2692",2005,"Chickasaw",12561,28143,353508,2746,117,0.0339,3.15,181689,32735,26578,6157,180314,20820,49291,8998,16887,116175,6188,8995,69135,5107,2366,1396,1345,214424,180314,34110,5107,39217,6196,0,33021,5076,771,38868,65514
"2693",2005,"Clarke",9180,26466,242959,1607,102,0.0339,3.15,62889,9586,7928,1658,53703,10312,8907,1690,2925,49151,1488,2963,25418,2702,2131,122,449,72475,53703,18772,2702,21474,850,0,20624,2382,323,23329,13738
"2694",2005,"Clay",16848,31567,531848,3281,133,0.0339,3.15,204888,33064,26860,6204,182883,31363,44489,10481,16991,122226,5218,9899,64442,5209,1725,1805,1679,237952,182883,55069,5209,60278,13217,0,47061,5856,775,53692,82662
"2695",2005,"Clayton",18269,26996,493191,2716,144,0.0339,3.15,195136,39796,28925,10871,204482,26115,36963,9422,16318,139420,7480,9682,98502,5749,4082,133,1534,234932,204482,30450,5749,36199,3619,0,32580,5156,870,38606,55716
"2696",2005,"Clinton",49475,28274,1398860,3157,171,0.0339,3.15,135546,39058,30428,8630,162169,9185,30475,11440,24372,70015,6112,7461,73124,5209,2633,1228,1348,174604,162169,12435,5209,17644,2173,0,15471,3973,642,20086,65531
"2697",2005,"Crawford",16920,29455,498384,2880,138,0.0339,3.15,225642,37875,29090,8785,199911,24697,57722,11497,21432,122244,5322,7124,72117,7183,3434,2155,1594,263517,199911,63606,7183,70789,4036,0,66753,3782,546,71081,103398
"2698",2005,"Dallas",53042,35892,1903771,3167,133,0.0339,3.15,136468,31052,21705,9347,133221,9550,19749,9255,15195,57961,4124,15333,60015,3889,1200,1744,945,167520,133221,34299,3889,38188,4694,0,33494,8850,1188,43532,78507
"2699",2005,"Davis",8583,22054,189286,1676,111,0.0339,3.15,58786,13170,9746,3424,74464,9191,11264,2973,6040,41326,2404,2578,40014,3085,2449,106,530,71956,74464,-2508,3085,577,96,0,481,1424,223,2128,17460
"2700",2005,"Decatur",8618,20735,178690,1321,102,0.0339,3.15,55798,13911,8942,4969,59766,7432,13322,2085,4455,36986,2094,2336,28042,3032,2454,158,420,69709,59766,9943,3032,12975,778,0,12197,1189,188,13574,18812
"2701",2005,"Delaware",17955,27839,499841,3494,154,0.0339,3.15,246904,42275,33011,9264,264026,34563,66609,10543,18926,185168,8758,9297,115330,6752,3973,837,1942,289179,264026,25153,6752,31905,2283,0,29622,5101,914,35637,61736
"2702",2005,"Des Moines",40332,30160,1216399,2947,136,0.0339,3.15,55390,16818,12652,4166,56623,2651,5525,5488,10239,19011,2351,2216,28153,1995,662,830,503,72208,56623,15585,1995,17580,2965,0,14615,842,153,15610,36379
"2703",2005,"Dickinson",16644,36882,613859,3049,124,0.0339,3.15,89482,18388,14591,3797,90416,6462,21453,7008,11247,36597,3038,4418,36790,2689,945,1059,685,107870,90416,17454,2689,20143,2614,0,17529,2198,293,20020,52885
"2704",2005,"Dubuque",90769,30889,2803785,3267,152,0.0339,3.15,210764,30862,22394,8468,210218,28074,59561,7069,14147,168384,7535,8776,85056,6755,5298,NA,1466,241626,210218,31408,6755,38163,2150,0,36013,4581,795,41389,42380
"2705",2005,"Emmet",10527,27946,294185,3380,125,0.0339,3.15,142779,22686,19340,3346,141974,23166,38583,7696,14628,80447,3681,4125,50095,4177,1526,1389,1262,165465,141974,23491,4177,27668,5028,0,22640,2381,336,25357,62332
"2706",2005,"Fayette",21426,25377,543719,3032,143,0.0339,3.15,238993,47278,37444,9834,230531,31982,38493,11970,21598,146100,7930,10154,108404,6766,3247,1638,1881,286271,230531,55740,6766,62506,9362,0,53144,5766,881,59791,92893
"2707",2005,"Floyd",16520,28731,474639,3058,124,0.0339,3.15,145965,32275,26175,6100,141347,12737,25522,9918,16654,65288,5393,6864,64259,3964,1274,1569,1121,178240,141347,36893,3964,40857,6906,0,33951,4530,700,39181,80677
"2708",2005,"Franklin",10766,31707,341358,3273,142,0.0339,3.15,261983,40154,32948,7206,236607,42035,63471,12138,21851,168788,6513,10170,80429,5812,1881,1805,2126,302137,236607,65530,5812,71342,10937,0,60405,5272,741,66418,93195
"2709",2005,"Fremont",7616,32113,244572,2588,125,0.0339,3.15,77783,24502,18165,6337,65994,1960,4246,6347,11069,15911,2730,3617,36025,2878,926,1419,533,102285,65994,36291,2878,39169,6987,0,32182,1944,291,34417,61872
"2710",2005,"Greene",9800,30669,300557,3154,142,0.0339,3.15,162052,33451,26475,6976,156464,12429,44525,11077,20034,73259,4662,6149,57588,4549,1294,2059,1196,195503,156464,39039,4549,43588,7614,0,35974,3294,470,39738,88793
"2711",2005,"Grundy",12406,33307,413205,3759,167,0.0339,3.15,184408,37127,26528,10599,173357,18848,33433,10588,20746,82436,5622,10727,73393,4834,1303,2128,1403,221535,173357,48178,4834,53012,9256,0,43756,5461,772,49989,101972
"2712",2005,"Guthrie",11249,31792,357624,2643,125,0.0339,3.15,148668,24881,21171,3710,141077,17436,32713,7756,12322,89230,4574,7731,58545,4285,2032,1163,1090,173549,141077,32472,4285,36757,7649,0,29108,5295,742,35145,59438
"2713",2005,"Hamilton",16261,31436,511186,3785,141,0.0339,3.15,273358,37252,28233,9019,261192,55776,55176,11312,19296,179214,7926,14121,97585,5527,1116,1894,2517,310610,261192,49418,5527,54945,9123,0,45822,10145,1377,57344,94144
"2714",2005,"Hancock",11834,30920,365907,3344,141,0.0339,3.15,211209,36766,30049,6717,196297,30500,38453,12572,21184,119822,5974,7572,80042,5040,1364,1884,1792,247975,196297,51678,5040,56718,14450,0,42268,4611,645,47524,91387
"2715",2005,"Hardin",17974,30627,550495,3387,145,0.0339,3.15,339115,40555,30205,10350,289993,72406,75594,11120,18066,250165,6434,12898,93475,7078,2463,1717,2898,379670,289993,89677,7078,96755,17117,NA,79639,8910,1260,89809,88950
"2716",2005,"Harrison",15362,29913,459519,2756,141,0.0339,3.15,108529,31144,25900,5244,109345,5024,15257,10187,17806,33837,4226,5752,51093,4141,1694,1539,908,139673,109345,30328,4141,34469,2739,0,31730,3023,455,35208,74692
"2717",2005,"Henry",20354,27435,558412,2812,132,0.0339,3.15,95552,19464,16158,3306,97095,13924,17388,5363,10127,55024,3365,3845,43083,3027,1307,879,841,115016,97095,17921,3027,20948,3990,0,16958,2107,308,19373,40528
"2718",2005,"Howard",9760,29327,286233,2422,118,0.0339,3.15,147032,28652,22696,5956,140354,19553,21296,8469,14067,81442,5304,5962,65703,4201,1728,1271,1202,175684,140354,35330,4201,39531,3825,0,35706,3642,557,39905,65590
"2719",2005,"Humboldt",10033,31701,318055,3600,137,0.0339,3.15,116894,29461,23706,5755,111264,10499,14646,8317,15466,44429,4218,3687,54431,3349,785,1607,957,146355,111264,35091,3349,38440,4844,0,33596,2265,337,36198,72465
"2720",2005,"Ida",7369,32407,238804,3243,147,0.0339,3.15,128861,25830,19851,5979,120315,11941,26989,7987,14447,64980,3883,5349,49719,4434,2099,1377,958,154691,120315,34376,4434,38810,5240,0,33570,2995,426,36991,63881
"2721",2005,"Iowa",16297,32533,530197,2708,144,0.0339,3.15,140556,29037,22077,6960,143575,13755,30910,7970,15541,75459,5756,7569,62074,4415,2402,933,1080,169593,143575,26018,4415,30433,5843,0,24590,4579,910,30079,65097
"2722",2005,"Jackson",20124,26314,529539,2724,158,0.0339,3.15,124597,24661,19065,5596,138782,11850,49231,4785,9822,96564,4520,5928,52646,5644,4760,80,804,149258,138782,10476,5644,16120,2041,0,14079,3289,508,17876,28033
"2723",2005,"Jasper",37482,28754,1077746,2924,148,0.0339,3.15,190710,36189,29512,6677,166559,19411,24277,12964,22677,86069,6064,6408,74758,5636,2250,1849,1537,226899,166559,60340,5636,65976,11508,0,54468,4118,658,59244,104641
"2724",2005,"Jefferson",16315,29954,488704,2099,113,0.0339,3.15,61921,17485,13575,3910,64268,6099,11107,3855,7696,33003,2271,2367,30873,2444,1269,675,500,79406,64268,15138,2444,17582,2731,0,14851,1368,232,16451,28918
"2725",2005,"Johnson",120300,33420,4020474,3473,141,0.0339,3.15,130850,29419,20167,9252,140714,16922,21681,8466,16244,77400,5929,9354,62118,3858,1869,781,1208,160269,140714,19555,3858,23413,3541,0,19872,4644,675,25191,53450
"2726",2005,"Jones",20605,24530,505436,3059,151,0.0339,3.15,138864,32765,25018,7747,157299,13004,41437,8935,16529,84711,5846,6834,64714,4852,2861,883,1108,171629,157299,14330,4852,19182,3288,0,15894,3962,654,20510,54153
"2727",2005,"Keokuk",10881,27504,299275,2460,127,0.0339,3.15,118641,28193,22477,5716,122037,15077,22843,7126,13299,71046,4732,4105,54855,4123,2100,998,1025,146834,122037,24797,4123,28920,4427,0,24493,2301,341,27135,47595
"2728",2005,"Kossuth",16287,34358,559594,3456,134,0.0339,3.15,380365,62902,52676,10226,344400,46352,90551,20690,35072,218678,10674,13344,127717,9315,2942,3498,2875,443267,344400,98867,9315,108182,15774,NA,92409,7856,1099,101364,161687
"2729",2005,"Lee",36364,27234,990339,2620,115,0.0339,3.15,71623,16159,13310,2849,74572,4538,9042,6038,11265,34249,3602,3344,36743,2802,1505,669,628,87782,74572,13210,2802,16012,3684,0,12328,2152,364,14844,37374
"2730",2005,"Linn",200395,34996,7012985,3661,143,0.0339,3.15,128516,33053,25065,7988,139218,10395,23067,9832,18654,60151,5801,8219,63250,5197,2781,1310,1106,161569,139218,22351,5197,27548,4900,0,22648,4597,644,27889,68365
"2731",2005,"Louisa",11862,28162,334054,2918,136,0.0339,3.15,82338,18238,14956,3282,81442,10710,13522,5215,9372,45017,2495,4742,35386,2215,730,779,706,100576,81442,19134,2215,21349,4522,0,16827,3028,455,20310,37321
"2732",2005,"Lucas",9462,23989,226981,1555,93,0.0339,3.15,32496,8843,7320,1523,36858,4369,6907,1404,3014,19728,1402,1646,18116,2155,1795,95,265,41339,36858,4481,2155,6636,336,0,6300,865,141,7306,12768
"2733",2005,"Lyon",11677,30570,356969,3088,139,0.0339,3.15,383763,36143,26132,10011,342432,61244,138510,10957,15572,303741,6630,12701,96818,10758,6359,1889,2510,419906,342432,77474,10758,88232,18245,NA,69988,7689,1106,78783,80022
"2734",2005,"Madison",14918,31023,462798,2427,122,0.0339,3.15,80728,15948,12153,3795,76726,9271,7761,5115,8522,41938,2724,5325,38008,3411,2198,561,652,96676,76726,19950,3411,23361,5079,0,18282,3489,490,22261,38790
"2735",2005,"Mahaska",22454,28689,644181,2619,131,0.0339,3.15,174938,29892,23037,6855,167175,23591,50466,7480,12913,122725,4995,7248,60482,5040,2396,1367,1277,204830,167175,37655,5040,42695,8372,0,34323,3986,594,38903,52213
"2736",2005,"Marion",32774,29404,963702,2563,131,0.0339,3.15,77107,18887,15094,3793,71094,5863,8178,5490,8933,31588,2671,4198,35761,2827,1407,848,572,95994,71094,24900,2827,27727,4365,0,23362,2205,318,25885,45519
"2737",2005,"Marshall",39646,30334,1202613,3303,145,0.0339,3.15,155260,34549,27939,6610,146947,11879,20523,11118,20059,61814,5662,10383,67323,4667,1527,1928,1212,189809,146947,42862,4667,47529,9172,0,38357,6027,868,45252,93446
"2738",2005,"Mills",14905,37470,558496,2714,119,0.0339,3.15,56120,18956,15623,3333,47444,385,1434,5917,9310,4617,2016,2994,25388,2065,406,1242,417,75076,47444,27632,2065,29697,3919,0,25778,1148,221,27147,51503
"2739",2005,"Mitchell",10800,28738,310372,2995,131,0.0339,3.15,194970,31660,24405,7255,185477,27073,46104,10168,16798,124334,5844,8083,71407,5801,2845,1411,1545,226630,185477,41153,5801,46954,5389,0,41565,5114,774,47453,70636
"2740",2005,"Monona",9566,27979,267646,2492,137,0.0339,3.15,116749,29721,23797,5924,118472,5309,25852,9788,18314,42641,4284,4669,50256,3894,1459,1516,919,146470,118472,27998,3894,31892,2562,0,29330,2170,341,31841,74108
"2741",2005,"Monroe",7955,29482,234528,1718,93,0.0339,3.15,42981,9800,7523,2277,48748,3027,8235,2414,5265,25434,1965,2069,25773,2016,1706,NA,318,52781,48748,4033,2016,6049,342,0,5707,1193,164,7064,17547
"2742",2005,"Montgomery",11214,28565,320331,2404,121,0.0339,3.15,84938,21530,15850,5680,77940,8018,10214,6950,9310,33803,3067,7301,33080,3019,1254,1080,685,106468,77940,28528,3019,31547,5154,0,26393,5250,712,32355,51135
"2743",2005,"Muscatine",41894,32508,1361888,3311,142,0.0339,3.15,75744,19973,16480,3493,91373,8175,10454,6810,13143,33638,3504,4153,45134,2618,1043,786,789,95717,91373,4344,2618,6962,1449,0,5513,2413,353,8279,42106
"2744",2005,"O'Brien",14552,32528,473341,3811,138,0.0339,3.15,320326,36107,28744,7363,278579,48963,105259,11469,18787,225289,6015,7581,80505,8532,4064,2238,2230,356433,278579,77854,8532,86386,13334,NA,73053,3525,506,77084,95037
"2745",2005,"Osceola",6743,31165,210147,3261,140,0.0339,3.15,234842,27524,19932,7592,196807,40557,52693,8947,13632,170878,5046,10097,65835,5519,2195,1531,1793,262366,196807,65559,5519,71078,17372,0,53706,6252,866,60824,63964
"2746",2005,"Page",16274,28339,461183,2206,118,0.0339,3.15,91244,21268,16628,4640,80087,3560,14913,6236,11258,34310,2794,4026,37300,4162,2351,1228,583,112512,80087,32425,4162,36587,3473,0,33114,1961,280,35355,56934
"2747",2005,"Palo Alto",9702,30730,298142,3248,133,0.0339,3.15,288193,37564,28866,8698,249015,48552,74699,11762,20188,193492,6081,8876,78857,6484,2432,1781,2271,325757,249015,76742,6484,83226,17358,0,65868,4943,668,71479,94701
"2748",2005,"Plymouth",24980,33665,840958,3386,129,0.0339,3.15,405007,53168,36128,17040,366478,62311,131519,14412,24048,295078,7752,11507,114929,10571,5277,2456,2838,458175,366478,91697,10571,102268,11503,NA,90766,6361,904,98031,109929
"2749",2005,"Pocahontas",7835,30698,240516,3547,128,0.0339,3.15,175073,37357,30360,6997,152741,18084,28471,11351,21888,81704,5427,6291,61229,4738,1259,2054,1425,212430,152741,59689,4738,64427,9661,0,54766,3682,510,58958,93369
"2750",2005,"Polk",399030,39894,15918973,3180,142,0.0339,3.15,80674,22935,15173,7762,86378,2835,6803,8567,13451,16338,3450,6457,44815,2291,641,971,679,103609,86378,17231,2291,19522,3248,0,16274,4087,603,20964,64336
"2751",2005,"Pottawattamie",90198,31473,2838775,2973,132,0.0339,3.15,240190,46329,37762,8567,225851,16346,76789,17786,24259,107975,6824,7316,76531,8574,4163,2810,1601,286519,225851,60668,8574,69242,20480,0,48762,3897,584,53243,132215
"2752",2005,"Poweshiek",19002,31730,602925,2767,148,0.0339,3.15,122308,27016,23445,3571,111498,9845,11643,7901,15325,51360,3919,6071,56794,4166,1819,1421,926,149324,111498,37826,4166,41992,11036,0,30956,4043,676,35675,70948
"2753",2005,"Ringgold",5304,23812,126301,1494,112,0.0339,3.15,67546,12635,10960,1675,69133,9854,13833,2525,5170,44776,2439,3096,32216,3216,2412,284,520,80181,69133,11048,3216,14264,425,0,13839,1997,297,16133,22770
"2754",2005,"Sac",10716,31931,342175,3425,145,0.0339,3.15,289891,36202,27236,8966,269504,51919,89344,11754,17936,200103,6501,10265,81785,7069,2786,1996,2287,326093,269504,56589,7069,63658,11139,NA,52520,6270,881,59671,89788
"2755",2005,"Scott",158543,35800,5675918,4707,159,0.0339,3.15,102694,27548,19217,8331,120084,10855,15485,9017,17478,47790,4852,6035,56362,3262,1300,912,1050,130242,120084,10158,3262,13420,3439,0,9981,3595,527,14103,54904
"2756",2005,"Shelby",12547,30417,381647,2925,135,0.0339,3.15,162984,31385,27001,4384,159061,15741,38478,10255,19491,75763,5041,8353,61702,5069,1847,1957,1265,194369,159061,35308,5069,40377,2793,0,37584,5330,783,43697,87221
"2757",2005,"Sioux",32726,30729,1005650,3617,143,0.0339,3.15,977684,68794,46154,22640,858796,175038,405961,17316,26192,847384,13490,28850,191949,23463,14584,2605,6274,1046478,858796,187682,23463,211145,49494,NA,161653,16941,2554,181148,130300
"2758",2005,"Story",82884,30866,2558261,3679,144,0.0339,3.15,144251,40561,28005,12556,134254,8349,14304,11723,21372,40126,5234,11389,61883,3958,952,1863,1143,184812,134254,50558,3958,54516,9763,0,44753,4096,656,49505,104125
"2759",2005,"Tama",18197,27310,496969,3015,149,0.0339,3.15,165514,40277,32304,7973,151758,11118,21958,10932,22689,59150,5719,7205,72137,5008,1791,1971,1246,205791,151758,54033,5008,59041,9380,0,49661,3934,562,54157,106364
"2760",2005,"Taylor",6534,27051,176751,1791,123,0.0339,3.15,95471,18318,14523,3795,84369,10230,13311,4463,7529,56064,3152,6184,39500,3421,1994,782,645,113789,84369,29420,3421,32841,973,0,31868,3213,488,35569,39407
"2761",2005,"Union",12143,26656,323682,1927,132,0.0339,3.15,80450,13827,11058,2769,83400,11531,23508,2793,5510,54889,2336,3789,33933,2980,1939,458,583,94277,83400,10877,2980,13857,1130,0,12727,2244,322,15293,25561
"2762",2005,"Van Buren",7638,23796,181753,1850,115,0.0339,3.15,77025,10992,8690,2302,69440,12183,14258,3204,6049,53588,2232,2776,28738,2591,1726,253,612,88017,69440,18577,2591,21168,5305,0,15863,1616,233,17712,23437
"2763",2005,"Wapello",35855,26464,948874,2056,113,0.0339,3.15,45734,13336,11448,1888,54496,3712,7664,3559,6753,20435,2241,2494,28073,2023,1120,500,403,59070,54496,4574,2023,6597,807,0,5790,1201,177,7168,25299
"2764",2005,"Warren",43339,32297,1399724,2716,122,0.0339,3.15,61748,19270,15037,4233,67950,3336,7022,4492,8273,23057,2711,3401,38715,2762,1657,645,460,81018,67950,13068,2762,15830,2065,0,13765,1468,216,15449,38691
"2765",2005,"Washington",21350,31982,682809,3144,141,0.0339,3.15,238385,33221,24663,8558,214448,41996,51763,8329,15193,182085,6439,8438,82290,5312,2317,1098,1897,271606,214448,57158,5312,62470,19207,0,43263,4502,672,48437,56300
"2766",2005,"Wayne",6494,23311,151379,1485,100,0.0339,3.15,47918,15498,12594,2904,50909,2460,5167,3488,6815,19427,2176,2244,28559,2711,2017,328,366,63416,50909,12507,2711,15218,715,0,14503,858,191,15552,28491
"2767",2005,"Webster",38562,29231,1127209,3732,133,0.0339,3.15,191169,40205,34193,6012,178371,21825,22599,13558,24957,74398,6155,8388,80889,4840,866,2302,1672,231374,178371,53003,4840,57843,8445,0,49398,4373,620,54391,116771
"2768",2005,"Winnebago",11340,27460,311396,3013,128,0.0339,3.15,121032,27800,22840,4960,123415,21903,15027,8149,13738,57903,4137,7343,53118,3322,684,1413,1225,148832,123415,25417,3322,28739,7439,0,21300,5014,726,27040,63129
"2769",2005,"Winneshiek",21060,30255,637161,2522,138,0.0339,3.15,181114,38435,27019,11416,187376,20162,32453,8785,15467,129723,6682,10741,93086,6100,4154,641,1305,219549,187376,32173,6100,38273,2480,0,35793,6269,945,43007,51391
"2770",2005,"Woodbury",100589,29572,2974643,2650,135,0.0339,3.15,197291,45680,33467,12213,190691,16025,56140,12115,20695,102488,5307,7458,72951,6776,3386,2041,1349,242971,190691,52280,6776,59056,6174,0,52882,4244,620,57746,94803
"2771",2005,"Worth",7742,26146,202419,3025,121,0.0339,3.15,74591,23612,19633,3979,76379,3602,4311,7140,13853,15989,3811,1996,41666,2456,416,1347,693,98203,76379,21824,2456,24280,1933,0,22347,808,148,23303,58602
"2772",2005,"Wright",13717,34812,477522,3707,144,0.0339,3.15,303144,36126,31778,4348,265538,62627,39208,11084,18911,213539,6232,16234,111242,6127,1437,2056,2634,339270,265538,73732,6127,79859,11969,NA,67891,10715,1514,80120,89605
"2773",2006,"Adair",7924,29886,236819,2198,114,0.0324,4.73,109577,15496,11169,4327,104337,8351,18562,6913,12765,46603,3729,4928,49089,-4575,2029,-6313,-291,125073,104337,20736,-4575,16161,2523,0,13638,3198,493,17329,62974
"2774",2006,"Adams",4224,27405,115758,2203,123,0.0324,4.73,63685,10501,8034,2467,63507,6278,15627,3626,5908,31530,2790,2379,26899,-2202,1301,-3330,-173,74186,63507,10679,-2202,8477,442,0,8035,1350,301,9686,32155
"2775",2006,"Allamakee",14378,28284,406664,2126,129,0.0324,4.73,122103,17538,11994,5544,114328,13830,21375,4400,7826,93321,4822,6036,56039,-1296,2746,-3746,-296,139641,114328,25313,-1296,24017,1066,0,22951,3966,620,27537,28782
"2776",2006,"Appanoose",13319,24937,332132,1564,106,0.0324,4.73,33297,7900,6000,1900,36575,1505,4705,2102,4354,16464,1845,1132,20932,-631,1537,-2080,-88,41197,36575,4622,-631,3991,141,0,3850,490,84,4424,16833
"2777",2006,"Audubon",6265,35441,222037,3311,134,0.0324,4.73,182546,18097,12723,5374,153987,22361,46711,8305,11142,111882,4945,5960,54563,-4659,2129,-6339,-449,200643,153987,46656,-4659,41997,3308,0,38689,4221,584,43494,70664
"2778",2006,"Benton",26137,31828,831888,3619,147,0.0324,4.73,196915,26027,17300,8727,185585,11629,39283,11502,22790,85294,6746,8558,85077,-9106,1886,-10513,-479,222942,185585,37357,-9106,28251,4528,0,23723,4563,667,28953,111621
"2779",2006,"Black Hawk",127486,31874,4063478,3952,157,0.0324,4.73,152434,19117,12920,6197,134690,13333,20269,9965,16209,59545,6675,6349,61890,-7814,962,-8351,-425,171551,134690,36861,-7814,29047,4918,0,24129,4168,610,28907,92889
"2780",2006,"Boone",26471,34780,920658,3917,136,0.0324,4.73,132786,20022,12356,7666,120574,5557,13831,11439,19264,36247,5981,6504,57998,-7773,900,-8299,-374,152808,120574,32234,-7773,24461,7403,0,17058,4393,617,22068,96539
"2781",2006,"Bremer",24054,32658,785546,3621,132,0.0324,4.73,133275,15987,11754,4233,122814,13867,20745,8806,15607,60372,5343,3701,54745,-5964,1228,-6787,-405,149262,122814,26448,-5964,20484,2172,0,18312,2068,327,20707,72903
"2782",2006,"Buchanan",20957,28769,602916,3562,148,0.0324,4.73,218238,23723,14917,8806,200537,25220,34469,13113,22187,109779,8236,6262,91050,-7967,2081,-9403,-645,241961,200537,41424,-7967,33457,4291,0,29166,4074,647,33887,108459
"2783",2006,"Buena Vista",19909,29023,577826,3914,147,0.0324,4.73,285706,27054,14853,12201,255806,58915,75755,12464,19060,192930,7175,7348,75089,-6251,2878,-8163,-966,312760,255806,56954,-6251,50703,10770,NA,39932,4533,663,45128,92776
"2784",2006,"Butler",14931,31056,463693,3458,156,0.0324,4.73,218583,21299,14464,6835,182424,27782,34506,11479,19918,113334,6722,7608,74409,-7365,2132,-8871,-626,239882,182424,57458,-7365,50093,3679,0,46414,4888,764,52066,105249
"2785",2006,"Calhoun",10093,31771,320666,3958,131,0.0324,4.73,225904,21790,16291,5499,191757,25276,56448,11321,20084,122171,7004,5409,66215,-7835,1800,-9034,-601,247694,191757,55937,-7835,48102,6035,0,42067,3512,509,46088,103733
"2786",2006,"Carroll",20832,33982,707913,3581,149,0.0324,4.73,402799,23240,14307,8933,373428,62702,168868,10882,18192,309426,8163,9450,95171,-4237,5462,-8701,-998,426039,373428,52611,-4237,48374,4883,NA,43490,6443,975,50908,93373
"2787",2006,"Cass",14021,31944,447886,2950,128,0.0324,4.73,152658,17505,12010,5495,129410,11107,34705,8192,11870,77257,4880,5393,53263,-5677,2158,-7501,-334,170163,129410,40753,-5677,35076,3512,0,31564,3157,473,35194,75401
"2788",2006,"Cedar",18332,31999,586601,4012,155,0.0324,4.73,163985,27906,17348,10558,158663,11644,29279,11545,21791,67665,6586,7087,70731,-7486,1592,-8610,-468,191891,158663,33228,-7486,25742,4640,0,21102,4083,633,25818,96320
"2789",2006,"Cerro Gordo",44531,33818,1505964,3567,146,0.0324,4.73,149790,24781,15605,9176,125583,8014,13682,13303,21933,45702,6105,4495,58051,-8681,970,-9211,-440,174571,125583,48988,-8681,40307,3690,0,36617,2426,380,39423,104088
"2790",2006,"Cherokee",12215,31476,384477,3581,141,0.0324,4.73,222657,24152,11836,12316,198997,27525,72354,9636,14916,145484,6340,5366,62860,-4547,3463,-7449,-561,246809,198997,47812,-4547,43265,4941,0,38324,2701,425,41450,77173
"2791",2006,"Chickasaw",12603,29078,366475,2909,126,0.0324,4.73,193490,20254,12673,7581,185225,20321,52819,9496,17067,120004,7137,7695,70690,-5499,2306,-7297,-508,213744,185225,28519,-5499,23020,3443,0,19577,4441,686,24704,73486
"2792",2006,"Clarke",9196,27323,251265,1811,110,0.0324,4.73,57648,7475,5499,1976,47640,8712,8416,1667,2637,43462,1655,1919,22634,-726,1483,-2061,-148,65123,47640,17483,-726,16757,642,0,16115,1410,194,17719,14186
"2793",2006,"Clay",16812,32466,545821,3612,135,0.0324,4.73,213604,20560,13114,7446,186387,28028,51383,11356,17034,122337,5794,9366,63426,-6782,1995,-8177,-600,234164,186387,47777,-6782,40995,7984,0,33011,5790,780,39581,91267
"2794",2006,"Clayton",18272,27406,500758,2919,155,0.0324,4.73,198885,31266,18574,12692,203547,24355,40986,10185,16283,134356,8386,8061,95291,-4163,3555,-7155,-563,230151,203547,26604,-4163,22441,2297,0,20144,4661,819,25624,64529
"2795",2006,"Clinton",49487,29819,1475660,3285,169,0.0324,4.73,177166,28505,18248,10257,179543,9346,34750,13441,26444,69787,7657,6865,81040,-8000,2179,-9670,-509,205671,179543,26128,-8000,18128,1977,0,16151,3845,656,20652,107379
"2796",2006,"Crawford",16868,28874,487050,3254,144,0.0324,4.73,224691,24879,13495,11384,202641,24303,60678,12495,21648,121669,6026,6058,71433,-6480,3113,-8987,-606,249570,202641,46929,-6480,40449,1885,0,38564,3654,557,42775,103022
"2797",2006,"Dallas",56158,37995,2133721,3385,124,0.0324,4.73,142662,23305,11700,11605,136073,8994,21165,9876,14791,62161,4751,15131,61365,-6401,978,-7031,-348,165967,136073,29894,-6401,23493,2431,0,21062,9766,1289,32117,80501
"2798",2006,"Davis",8619,22994,198189,1956,109,0.0324,4.73,59188,11036,7394,3642,69473,8903,11115,2911,5707,37887,2726,2242,35869,-961,1762,-2529,-194,70224,69473,751,-961,-210,-75,0,-135,1364,222,1451,21301
"2799",2006,"Decatur",8576,21199,181800,1465,102,0.0324,4.73,53323,12171,5863,6308,58066,6765,13818,2158,4135,34710,2241,1907,27042,-397,1767,-2017,-147,65494,58066,7428,-397,7031,413,0,6618,1124,181,7923,18613
"2800",2006,"Delaware",17957,28969,520199,3866,155,0.0324,4.73,276370,28413,17323,11090,276793,32787,79905,11083,18602,200128,9888,7705,116823,-5409,4617,-9302,-724,304783,276793,27990,-5409,22581,1449,NA,21131,4571,842,26544,76242
"2801",2006,"Des Moines",40192,32738,1315824,3179,132,0.0324,4.73,59413,13172,8117,5055,54774,2407,4349,5825,10183,17952,2702,1914,27394,-3671,436,-3921,-186,72585,54774,17811,-3671,14140,2126,0,12014,796,131,12941,41461
"2802",2006,"Dickinson",16667,38632,643878,3404,124,0.0324,4.73,101212,12805,8231,4574,96838,6205,26398,7478,11458,39826,3501,4099,37699,-4144,935,-4821,-258,114017,96838,17179,-4144,13035,1624,0,11411,2237,313,13961,61386
"2803",2006,"Dubuque",91258,32881,3000689,3513,162,0.0324,4.73,219626,23985,14137,9848,218750,27834,66945,7866,14242,169276,8745,7793,85325,-2850,4707,-6994,-563,243611,218750,24861,-2850,22011,1090,0,20921,4448,781,26150,50350
"2804",2006,"Emmet",10437,29085,303557,3721,128,0.0324,4.73,154783,16319,12251,4068,149251,22824,42468,8449,15221,83200,4239,3827,52223,-5369,1645,-6528,-486,171102,149251,21851,-5369,16482,2710,0,13772,2368,342,16482,71583
"2805",2006,"Fayette",21265,25943,551686,3337,150,0.0324,4.73,244460,32995,20859,12136,229698,31072,38968,12847,21362,141755,9118,8889,107442,-7653,3091,-10038,-706,277455,229698,47757,-7653,40104,5598,NA,34505,5463,841,40809,102705
"2806",2006,"Floyd",16586,29124,483056,3320,135,0.0324,4.73,149882,20658,12867,7791,142110,11746,27589,10607,16500,64681,6035,5517,64116,-6327,1352,-7268,-411,170540,142110,28430,-6327,22103,3489,0,18614,3883,611,23108,85201
"2807",2006,"Franklin",10699,32550,348252,3518,149,0.0324,4.73,291130,24058,15377,8681,245330,41832,69274,13364,21885,178412,7517,9112,82346,-8363,2731,-10278,-816,315188,245330,69858,-8363,61495,9053,NA,52441,5032,732,58205,112718
"2808",2006,"Fremont",7622,32482,247579,2832,117,0.0324,4.73,79747,17414,10042,7372,63139,1702,3745,6512,10116,13811,3003,3143,34918,-5341,624,-5779,-186,97161,63139,34022,-5341,28681,4686,0,23995,1821,284,26100,65936
"2809",2006,"Greene",9611,30874,296726,3470,141,0.0324,4.73,176359,22344,13756,8588,166909,11774,53607,12126,19690,78964,5354,5232,59126,-8123,1317,-8995,-445,198703,166909,31794,-8123,23671,3975,0,19696,2916,431,23043,97395
"2810",2006,"Grundy",12436,34220,425555,3996,167,0.0324,4.73,198108,26406,13806,12600,176327,18396,36447,11130,20542,81814,6444,9154,74214,-8230,1452,-9156,-526,224514,176327,48187,-8230,39957,6192,0,33765,5016,715,39496,116294
"2811",2006,"Guthrie",11150,33067,368699,2963,128,0.0324,4.73,158893,16264,11981,4283,141943,15294,34504,8506,12468,91359,5204,6765,59202,-4398,1794,-5801,-391,175157,141943,33214,-4398,28816,5774,0,23042,4961,725,28728,67534
"2812",2006,"Hamilton",16144,32405,523139,4097,142,0.0324,4.73,291344,27331,15762,11569,257364,50603,57606,12270,19427,176677,9017,11766,96675,-9274,2033,-10404,-903,318675,257364,61311,-9274,52037,7233,NA,44803,8861,1244,54908,114667
"2813",2006,"Hancock",11729,31810,373105,3592,144,0.0324,4.73,238376,24048,15832,8216,206347,29807,42763,14038,21892,130524,6827,6942,84078,-8459,1898,-9670,-687,262424,206347,56077,-8459,47618,11322,0,36296,4555,666,41517,107852
"2814",2006,"Hardin",17893,32295,577858,3667,146,0.0324,4.73,358097,28273,15352,12921,294488,67875,80963,12022,18138,249997,7427,10882,97181,-7203,4233,-10375,-1061,386370,294488,91882,-7203,84679,11213,NA,73465,7855,1154,82474,108100
"2815",2006,"Harrison",15346,31030,476188,3093,140,0.0324,4.73,110855,20040,13592,6448,104368,4269,13060,10412,16867,27702,4769,4397,50594,-6983,1046,-7708,-321,130895,104368,26527,-6983,19544,1493,0,18051,2384,359,20794,83153
"2816",2006,"Henry",20326,28793,585255,3073,123,0.0324,4.73,101918,14844,11173,3671,96240,13214,18130,5559,10116,53316,3851,3371,41999,-3776,1109,-4574,-311,116762,96240,20522,-3776,16746,2885,0,13861,1972,301,16134,48602
"2817",2006,"Howard",9664,29243,282608,2621,121,0.0324,4.73,151086,19260,12013,7247,144400,19417,23851,9111,14107,82990,6174,5001,66739,-4850,1883,-6274,-459,170346,144400,25946,-4850,21096,1927,0,19169,3378,526,23073,68096
"2818",2006,"Humboldt",10038,31921,320422,3873,146,0.0324,4.73,131740,19237,12200,7037,116282,10158,16660,9151,15738,45765,4863,2986,56726,-7142,932,-7710,-364,150977,116282,34695,-7142,27553,2795,0,24758,1924,296,26978,85975
"2819",2006,"Ida",7247,31010,224732,3668,156,0.0324,4.73,124621,18373,10196,8177,124235,11410,30558,8742,14508,65048,4518,4721,49778,-3443,2033,-5115,-361,142994,124235,18759,-3443,15316,1955,0,13361,2895,414,16670,59573
"2820",2006,"Iowa",16391,33371,546990,3131,145,0.0324,4.73,158122,21576,13264,8312,148056,13461,34460,8630,15338,77615,6589,6653,62925,-5002,2029,-6625,-406,179698,148056,31642,-5002,26640,4186,0,22454,4272,779,27505,80507
"2821",2006,"Jackson",20092,27619,554922,2931,156,0.0324,4.73,129310,18953,12479,6474,134469,10126,48688,5223,9637,88498,5009,4991,50795,-2092,3400,-5210,-282,148263,134469,13794,-2092,11702,1368,0,10334,3207,510,14051,40812
"2822",2006,"Jasper",37288,30444,1135214,3301,146,0.0324,4.73,203172,23216,15568,7648,168049,18075,24225,14332,22951,81115,7032,5490,75944,-8123,1994,-9542,-575,226388,168049,58339,-8123,50216,7424,0,42792,3754,581,47127,122057
"2823",2006,"Jefferson",16401,31900,523192,2375,110,0.0324,4.73,63570,14039,9340,4699,62226,5812,10561,3964,7357,30763,2622,1982,29928,-2974,995,-3787,-182,77609,62226,15383,-2974,12409,1761,0,10648,1215,206,12069,32807
"2824",2006,"Johnson",122226,35354,4321159,3911,141,0.0324,4.73,155009,23919,12296,11623,142573,15774,23009,9039,16349,79419,6977,8235,63190,-4498,1873,-5922,-449,178928,142573,36355,-4498,31857,4590,0,27267,4351,644,32262,75590
"2825",2006,"Jones",20678,25481,526888,3147,161,0.0324,4.73,161973,22773,13651,9122,165157,12559,48349,9524,16883,86844,6751,5912,65179,-5555,2507,-7643,-419,184746,165157,19589,-5555,14034,2345,0,11689,3551,625,15865,75129
"2826",2006,"Keokuk",10713,28403,304285,2836,134,0.0324,4.73,128030,22181,15157,7024,120772,14393,23361,7362,13251,68081,5230,3474,53701,-4225,1947,-5794,-378,150211,120772,29439,-4225,25214,3434,0,21780,2033,307,24120,59949
"2827",2006,"Kossuth",16045,35624,571587,3707,137,0.0324,4.73,409924,39071,26817,12254,352158,44598,95571,22187,34951,223902,12241,11848,130762,-14605,3770,-17301,-1074,448995,352158,96837,-14605,82232,11432,NA,70799,7558,1093,79450,186022
"2828",2006,"Lee",36291,28224,1024277,2893,132,0.0324,4.73,73083,11202,7949,3253,73298,3899,8274,6369,11226,30339,4139,2884,36507,-2704,1203,-3678,-229,84285,73298,10987,-2704,8283,1681,0,6602,1940,345,8887,42744
"2829",2006,"Linn",202709,36849,7469626,3983,141,0.0324,4.73,144517,23770,13981,9789,139799,9891,23363,10698,19257,57511,6716,7175,62699,-6112,2267,-7958,-421,168287,139799,28488,-6112,22376,3467,0,18909,4409,635,23953,87006
"2830",2006,"Louisa",11904,29076,346119,3413,132,0.0324,4.73,91929,12574,9078,3496,81519,10281,14697,5325,9152,45328,2830,4034,35200,-3634,882,-4256,-260,104503,81519,22984,-3634,19350,3859,0,15491,2758,414,18663,46601
"2831",2006,"Lucas",9331,24974,233033,1672,110,0.0324,4.73,31541,6879,5219,1660,35326,3971,7236,1419,2767,19574,1555,1253,17125,-243,1394,-1544,-93,38420,35326,3094,-243,2851,137,0,2714,712,122,3548,11967
"2832",2006,"Lyon",11604,31609,366786,3447,133,0.0324,4.73,413296,24925,12890,12035,358689,58683,157793,11674,15389,326177,7551,11664,95935,-2548,6909,-8526,-931,438221,358689,79532,-2548,76984,14658,NA,62325,7782,1162,71269,87119
"2833",2006,"Madison",15262,32431,494962,2644,125,0.0324,4.73,86068,11738,7537,4201,74629,8530,7385,5375,8260,40330,3123,4879,37077,-2255,1688,-3707,-236,97806,74629,23177,-2255,20922,4013,0,16909,3415,484,20808,45738
"2834",2006,"Mahaska",22298,29984,668594,2963,125,0.0324,4.73,182101,22136,13816,8320,168338,21576,55082,7746,12177,122400,5759,6219,59779,-4870,2352,-6767,-455,204237,168338,35899,-4870,31029,5705,0,25324,3757,582,29663,59701
"2835",2006,"Marion",33396,30469,1017557,2925,131,0.0324,4.73,77675,13199,8344,4855,68801,5355,8486,5872,8644,29118,3020,3245,34179,-3490,1009,-4291,-208,90874,68801,22073,-3490,18583,2675,0,15908,1873,291,18072,48557
"2836",2006,"Marshall",39601,31950,1265245,3433,149,0.0324,4.73,158665,21181,13569,7612,140790,11025,18109,11653,19612,53628,6294,8450,65647,-7911,1307,-8777,-441,179846,140790,39056,-7911,31145,5562,0,25583,5242,786,31611,105037
"2837",2006,"Mills",15214,38266,582172,3095,120,0.0324,4.73,60872,12771,8817,3954,46522,389,1308,6046,8869,3810,2292,2609,25009,-5320,281,-5451,-150,73643,46522,27121,-5320,21801,2788,0,19013,1113,243,20369,57062
"2838",2006,"Mitchell",10836,29650,321282,3252,130,0.0324,4.73,213732,20489,11929,8560,191546,25531,52584,10763,16894,131745,6621,6708,72445,-4630,3265,-7325,-570,234221,191546,42675,-4630,38045,3918,0,34127,4420,684,39231,81987
"2839",2006,"Monona",9479,26866,254665,2838,139,0.0324,4.73,115084,19943,12696,7247,118842,4693,26444,10494,18253,39184,4947,3735,50276,-5815,1080,-6555,-340,135027,118842,16185,-5815,10370,750,0,9620,1933,297,11850,75900
"2840",2006,"Monroe",7911,30424,240685,1981,110,0.0324,4.73,38618,8002,5100,2902,45117,2632,7375,2440,5159,21849,2240,1573,23698,-488,1208,-1582,-114,46620,45117,1503,-488,1015,56,0,959,946,146,2051,16769
"2841",2006,"Montgomery",11179,29560,330446,2630,122,0.0324,4.73,92764,15233,8807,6426,75665,7504,9316,6652,9010,33691,3449,6244,33490,-4341,1118,-5215,-244,107997,75665,32332,-4341,27991,3974,0,24017,4754,655,29426,59073
"2842",2006,"Muscatine",42145,34396,1449611,3647,154,0.0324,4.73,90936,14068,9890,4178,92563,7593,11063,7201,13079,34140,4013,3672,45942,-4197,903,-4809,-291,105004,92563,12441,-4197,8244,1500,0,6744,2261,347,9352,56796
"2843",2006,"O'Brien",14558,33222,483651,4255,143,0.0324,4.73,336824,23056,14316,8740,288887,47801,116816,12244,18985,231531,6646,6559,79836,-5989,4266,-9414,-841,359880,288887,70993,-5989,65004,8962,NA,56041,3423,501,59965,105293
"2844",2006,"Osceola",6713,31926,214316,3640,134,0.0324,4.73,249592,19922,10820,9102,203360,39225,59395,9321,13583,179547,5790,9460,66586,-4294,2920,-6544,-670,269514,203360,66154,-4294,61860,13111,NA,48748,6228,889,55865,70045
"2845",2006,"Page",16331,28820,470664,2372,120,0.0324,4.73,88074,15779,10493,5286,75912,3135,13702,6323,10572,29044,3147,3383,35650,-4280,1608,-5682,-206,103853,75912,27941,-4280,23661,2078,0,21583,1796,267,23646,59030
"2846",2006,"Palo Alto",9586,30945,296641,3525,135,0.0324,4.73,298212,25461,14313,11148,251851,46078,77079,13228,21095,191661,7116,8047,79208,-6528,2979,-8652,-855,323673,251851,71822,-6528,65294,12567,NA,52726,4804,676,58206,106551
"2847",2006,"Plymouth",24982,34336,857778,3830,135,0.0324,4.73,418007,39992,17293,22699,380564,60763,147130,15401,23411,303129,8796,9756,115307,-5698,6000,-10635,-1063,457999,380564,77435,-5698,71737,7149,NA,64587,5692,849,71128,114878
"2848",2006,"Pocahontas",7694,31527,242568,3830,134,0.0324,4.73,190198,23901,15209,8692,155622,17393,31766,12292,21691,81802,6017,5507,60956,-8696,1522,-9687,-531,214099,155622,58477,-8696,49781,7181,0,42600,3544,513,46657,108396
"2849",2006,"Polk",405990,41945,17029212,3487,138,0.0324,4.73,91523,16884,7477,9407,86949,2782,7492,9312,13572,16412,3970,5417,44404,-4703,541,-4986,-258,108407,86949,21458,-4703,16755,2540,0,14215,3562,529,18306,75111
"2850",2006,"Pottawattamie",90867,33518,3045716,3294,134,0.0324,4.73,264129,30407,20342,10065,236103,16185,86953,19716,23175,111998,7753,6406,75915,-10241,3245,-12885,-601,294536,236103,58433,-10241,48192,13523,NA,34668,3796,588,39052,152131
"2851",2006,"Poweshiek",19053,33772,643454,3124,148,0.0324,4.73,132838,17410,12955,4455,109725,8981,11771,8307,15279,49668,4448,5131,55808,-6939,1416,-8016,-339,150248,109725,40523,-6939,33584,7834,0,25750,3649,636,30035,83170
"2852",2006,"Ringgold",5230,24028,125669,1726,109,0.0324,4.73,65637,10194,8236,1958,67588,9426,14658,2539,4946,42526,2743,2458,30818,-1010,1843,-2663,-190,75831,67588,8243,-1010,7233,212,0,7021,1659,269,8949,23111
"2853",2006,"Sac",10707,31257,334674,3824,145,0.0324,4.73,303401,25025,13349,11676,289238,52742,105888,12189,17708,219185,7512,9332,83867,-4773,3499,-7387,-885,328426,289238,39188,-4773,34415,6419,NA,27995,6109,893,34997,84216
"2854",2006,"Scott",159597,37986,6062478,5073,174,0.0324,4.73,119456,21516,10862,10654,122312,10179,15566,9712,17480,47038,5629,5415,58331,-4846,1229,-5683,-392,140972,122312,18660,-4846,13814,3097,0,10717,3474,522,14713,72418
"2855",2006,"Shelby",12480,31079,387867,3287,136,0.0324,4.73,177068,18486,13629,4857,162700,15204,40003,11361,19767,73351,5811,7299,63255,-7913,1637,-9070,-480,195554,162700,32854,-7913,24941,1633,0,23308,4935,721,28964,103717
"2856",2006,"Sioux",33077,31023,1026147,4063,148,0.0324,4.73,1024244,49520,20836,28684,907102,168691,457677,18700,26281,880936,15440,26875,193438,-619,14328,-12603,-2344,1073764,907102,166662,-619,166043,38099,NA,127942,16519,2535,146996,143308
"2857",2006,"Story",84739,32723,2772884,4021,149,0.0324,4.73,157693,29842,13869,15973,134478,7867,14368,12553,21440,39188,5990,10427,61833,-8978,833,-9384,-427,187535,134478,53057,-8978,44079,7144,0,36935,3861,609,41405,118505
"2858",2006,"Tama",18149,28192,511664,3320,149,0.0324,4.73,187550,26551,17425,9126,155434,10675,27494,11456,22435,65384,6479,6532,70363,-8203,1745,-9486,-462,214101,155434,58667,-8203,50464,7417,0,43047,3739,548,47334,122166
"2859",2006,"Taylor",6557,27235,178577,1948,119,0.0324,4.73,101433,14713,10305,4408,86955,10023,15991,4447,6974,61291,3689,5884,39947,-2242,1729,-3734,-237,116146,86955,29191,-2242,26949,798,0,26151,3541,528,30220,40142
"2860",2006,"Union",12225,27940,341567,2085,136,0.0324,4.73,82820,10329,6935,3394,81449,10640,24102,2954,4978,55080,2568,3043,33164,-1666,1709,-3169,-206,93149,81449,11700,-1666,10034,779,0,9255,1947,283,11485,27740
"2861",2006,"Van Buren",7660,25006,191549,2159,109,0.0324,4.73,85842,8848,6277,2571,69523,12134,16727,3196,5913,55471,2497,2266,26790,-1551,1459,-2780,-230,94690,69523,25167,-1551,23616,5738,0,17878,1413,211,19502,30371
"2862",2006,"Wapello",35776,27777,993765,2237,110,0.0324,4.73,48714,8995,6771,2224,52946,3533,7618,3454,6389,19006,2568,1978,27406,-2624,810,-3289,-145,57709,52946,4763,-2624,2139,248,0,1891,1153,169,3213,29708
"2863",2006,"Warren",44178,34253,1513240,2935,130,0.0324,4.73,66506,13429,8533,4896,66551,3218,7346,4757,7626,22408,3076,2752,37776,-2928,1317,-4079,-166,79935,66551,13384,-2928,10456,1237,0,9219,1336,202,10757,44098
"2864",2006,"Washington",21472,34193,734188,3624,150,0.0324,4.73,257200,27537,16566,10971,213977,40251,53784,8619,14910,183813,7204,7092,82117,-4291,3162,-6753,-700,284737,213977,70760,-4291,66469,19270,NA,47198,3949,602,51749,73387
"2865",2006,"Wayne",6478,22805,147729,1596,99,0.0324,4.73,44967,12465,9215,3250,50519,2348,5492,3494,6453,16979,2393,1782,28557,-1588,1373,-2830,-131,57432,50519,6913,-1588,5325,241,0,5084,768,207,6059,27988
"2866",2006,"Webster",38534,30604,1179301,4040,134,0.0324,4.73,209786,25291,18501,6790,182506,20672,22450,14845,25171,76664,7168,7429,84771,-10546,1126,-11044,-628,235077,182506,52571,-10546,42025,5098,0,36927,4386,649,41962,133122
"2867",2006,"Winnebago",11138,28459,316976,3238,125,0.0324,4.73,133454,18008,11961,6047,125066,21673,17489,8650,13390,61414,4751,6921,52192,-6427,1055,-7020,-462,151462,125066,26396,-6427,19969,4401,0,15568,4966,743,21277,72040
"2868",2006,"Winneshiek",21012,31719,666479,2720,143,0.0324,4.73,175455,29761,15937,13824,181796,19182,32867,8844,14558,120628,7623,9490,89232,-4327,3221,-7075,-473,205216,181796,23420,-4327,19093,1107,0,17986,5843,913,24742,54827
"2869",2006,"Woodbury",100693,30187,3039663,3014,138,0.0324,4.73,201555,31827,16978,14849,197286,15624,60443,13098,20708,106454,6038,6591,74784,-6622,2833,-8946,-509,233382,197286,36096,-6622,29474,2734,0,26740,3998,608,31346,95101
"2870",2006,"Worth",7649,26879,205600,3268,126,0.0324,4.73,80421,15326,10581,4745,76881,3023,4654,7740,13665,14865,4398,1831,41570,-6089,389,-6224,-254,95747,76881,18866,-6089,12777,892,0,11885,778,145,12808,65556
"2871",2006,"Wright",13588,35807,486548,3988,137,0.0324,4.73,341724,22083,16854,5229,277743,58952,46735,11584,18756,234839,7149,14510,120057,-8312,2965,-10314,-963,363807,277743,86064,-8312,77752,11763,NA,65988,10059,1447,77494,106885
"2872",2007,"Adair",7871,32295,254196,2742,123,0.0285,4.36,135694,11193,7477,3716,123453,12492,14506,8522,17414,52888,5078,7841,57600,192,897,-561,-144,146887,123453,23434,192,23626,4625,0,19001,5632,926,25559,82806
"2873",2007,"Adams",4195,30629,128489,2688,141,0.0285,4.36,76840,8056,5716,2340,75294,9385,12391,4598,7896,31409,3926,3646,33452,455,853,-312,-86,84896,75294,9602,455,10057,696,0,9361,2517,494,12372,45431
"2874",2007,"Allamakee",14335,30238,433467,2640,131,0.0285,4.36,141973,13021,8187,4834,134077,20567,18048,5540,10679,103338,6651,9353,63239,2767,1427,1487,-147,154994,134077,20917,2767,23684,1144,0,22540,6638,1102,30280,38635
"2875",2007,"Appanoose",13105,25876,339102,1908,122,0.0285,4.36,38833,6240,4570,1670,41420,1994,2563,2668,5858,13212,2523,1640,24174,-63,415,-436,NA,45073,41420,3653,-63,3590,154,0,3436,835,143,4414,25621
"2876",2007,"Audubon",6222,38063,236831,3991,143,0.0285,4.36,204074,12171,7697,4474,177374,33586,36745,10771,15408,106748,6876,9556,64432,2542,2961,-193,-226,216245,177374,38871,2542,41413,3851,0,37562,7226,1138,45926,97326
"2877",2007,"Benton",26066,34757,905977,4485,158,0.0285,4.36,256003,18149,10528,7621,223018,16799,35414,14626,31208,102311,9264,12624,103083,2643,1404,1475,-236,274152,223018,51134,2643,53777,10497,0,43280,7507,1222,52009,153692
"2878",2007,"Black Hawk",127756,33632,4296710,5083,185,0.0285,4.36,180284,12529,7169,5360,162287,19414,16636,12748,22381,57937,9341,9029,72738,3810,1528,2493,-211,192813,162287,30526,3810,34336,6706,0,27630,6066,975,34671,122347
"2879",2007,"Boone",26553,36369,965717,4680,147,0.0285,4.36,173722,15440,8221,7219,145647,7647,10355,14673,26324,35760,8184,10233,68231,3137,802,2519,-184,189162,145647,43515,3137,46652,16631,0,30021,7343,1178,38542,137962
"2880",2007,"Bremer",24237,34940,846838,4603,137,0.0285,4.36,161637,10236,6561,3675,147087,20305,17377,11335,21481,63080,7435,5135,64019,3757,1333,2625,-201,171873,147087,24786,3757,28543,3702,0,24841,3207,531,28579,98557
"2881",2007,"Buchanan",21069,30803,648982,4518,163,0.0285,4.36,258074,16328,8503,7825,235464,35556,30144,15983,29906,114930,10945,8978,103952,7600,2977,4952,-329,274402,235464,38938,7600,46538,6837,0,39701,6756,1125,47582,143144
"2882",2007,"Buena Vista",19798,32205,637586,4846,147,0.0285,4.36,366478,19144,7463,11681,312240,89976,70194,15960,26431,224617,9768,10983,88928,5358,4972,877,-491,385622,312240,73382,5358,78740,18632,0,60108,7474,1209,68791,141861
"2883",2007,"Butler",14961,34237,512227,4398,179,0.0285,4.36,256883,15235,8924,6311,211396,39779,28477,13715,25897,109821,8771,10293,84464,6867,3392,3792,-317,272118,211396,60722,6867,67589,5850,0,61739,7469,1255,70463,147062
"2884",2007,"Calhoun",9947,36051,358596,4878,143,0.0285,4.36,272642,15393,10335,5058,222123,38413,45674,14686,27780,116219,9888,8221,77461,4667,3013,1959,-305,288035,222123,65912,4667,70579,9994,0,60585,5809,939,67333,156423
"2885",2007,"Carroll",20869,35920,749605,4434,159,0.0285,4.36,424718,16876,8416,8460,412797,96760,134390,14413,25362,289554,11661,15339,114872,8188,6023,2664,-499,441594,412797,28797,8188,36985,4424,NA,32560,10957,1804,45321,135164
"2886",2007,"Cass",13988,34411,481337,3598,142,0.0285,4.36,170975,13061,7812,5249,143769,15874,24701,10473,16055,77961,6642,8184,61840,840,1275,-273,-162,184036,143769,40267,840,41107,4298,0,36809,5323,868,43000,93014
"2887",2007,"Cedar",18321,34714,635987,4429,161,0.0285,4.36,197864,20087,9808,10279,191861,17470,23684,14939,30743,63876,9153,10826,85046,5070,1780,3528,-238,217951,191861,26090,5070,31160,6864,0,24296,6930,1147,32373,133988
"2888",2007,"Cerro Gordo",44461,35507,1578675,4439,162,0.0285,4.36,183314,17119,8706,8413,154924,11597,10748,17264,30696,41513,8400,6161,70058,6116,1321,5016,-221,200433,154924,45509,6116,51625,5121,0,46504,3555,592,50651,141801
"2889",2007,"Cherokee",12152,34497,419207,4466,152,0.0285,4.36,260232,19162,7071,12091,229762,42486,59391,12635,20634,146113,9082,8172,77362,2048,3106,-777,-281,279394,229762,49632,2048,51680,7217,0,44463,4732,790,49985,114119
"2890",2007,"Chickasaw",12540,31900,400023,3767,143,0.0285,4.36,223094,14616,7399,7217,214793,30673,41727,11959,23856,124063,9925,11209,85444,4460,2516,2200,-256,237710,214793,22917,4460,27377,4938,0,22439,6916,1141,30496,99031
"2891",2007,"Clarke",9149,29551,270362,2213,95,0.0285,4.36,60454,5918,4089,1829,50705,11587,5844,1973,3323,41100,2238,1923,23817,872,972,NA,-66,66372,50705,15667,872,16539,772,0,15767,1085,182,17034,19354
"2892",2007,"Clay",16725,35674,596643,4506,143,0.0285,4.36,260283,14950,8000,6950,221624,39319,47060,14612,23657,135184,7820,15022,74134,3169,2618,840,-289,275233,221624,53609,3169,56778,12605,0,44173,10052,1580,55805,125099
"2893",2007,"Clayton",18259,29705,542377,3610,153,0.0285,4.36,235245,23522,11959,11563,238585,35450,34683,13082,22520,145603,11405,11627,109818,6064,2613,3728,-277,258767,238585,20182,6064,26246,3469,0,22777,7570,1325,31672,89642
"2894",2007,"Clinton",49342,32590,1608035,3798,180,0.0285,4.36,225850,19630,10134,9496,214322,13768,26580,17408,36903,73248,10724,10160,98779,6072,1406,4923,-257,245480,214322,31158,6072,37230,4692,0,32538,6633,1143,40314,152602
"2895",2007,"Crawford",16931,32319,547194,4013,152,0.0285,4.36,273372,19435,8151,11284,233431,36911,48389,16115,30245,115625,8263,9017,84491,5514,3772,2049,-307,292807,233431,59376,5514,64890,3174,0,61716,6256,1032,69004,157747
"2896",2007,"Dallas",59164,41991,2484377,4327,134,0.0285,4.36,191010,18085,6949,11136,170452,13197,17647,12548,20031,80855,6600,25442,74987,1378,735,815,-172,209095,170452,38643,1378,40021,4416,0,35605,18411,2859,56875,110155
"2897",2007,"Davis",8676,24036,208536,2406,115,0.0285,4.36,65006,8654,5620,3034,77590,13361,8579,3422,7524,37364,3743,3388,37573,760,1178,-323,-95,73660,77590,-3930,760,-3170,-1125,0,-2045,2325,389,669,27642
"2898",2007,"Decatur",8569,22219,190397,1828,115,0.0285,4.36,57591,10851,4696,6155,64142,9644,9358,2675,5360,31655,2933,2740,31432,412,738,-256,-70,68442,64142,4300,412,4712,379,0,4333,1896,326,6555,25936
"2899",2007,"Delaware",17981,31668,569414,4628,176,0.0285,4.36,324443,20029,9704,10325,325860,48272,73533,13895,25383,224060,13504,11014,140259,10511,4450,6422,-361,344472,325860,18612,10511,29123,2135,0,26988,7386,1324,35698,100383
"2900",2007,"Des Moines",40206,34589,1390671,3899,163,0.0285,4.36,82028,9517,4756,4761,65833,3421,2795,7372,14044,17740,3746,2689,31766,1531,480,1143,-92,91545,65833,25712,1531,27243,4711,0,22532,1341,222,24095,64288
"2901",2007,"Dickinson",16634,41102,683685,4210,137,0.0285,4.36,125099,9105,4829,4276,113597,9247,21554,9500,16120,39929,4864,6372,45940,674,638,166,-130,134204,113597,20607,674,21281,3226,0,18055,3984,633,22672,85170
"2902",2007,"Dubuque",92130,34714,3198156,4239,178,0.0285,4.36,269982,17258,8315,8943,258114,42515,59222,10337,19845,202905,12216,11873,102106,7229,3432,4085,-288,287240,258114,29126,7229,36355,2026,0,34329,7705,1333,43367,67077
"2903",2007,"Emmet",10417,31866,331944,4515,136,0.0285,4.36,200869,10273,6436,3837,183426,34698,40324,10982,21772,98421,5891,6067,63692,3397,2135,1511,-249,211142,183426,27716,3397,31113,5860,0,25253,4141,667,30061,102448
"2904",2007,"Fayette",21005,28779,604512,4144,169,0.0285,4.36,294974,24372,12786,11586,268122,45007,31677,15819,28286,159917,12209,13006,122118,6521,3135,3740,-354,319346,268122,51224,6521,57745,9829,0,47916,9189,1506,58611,135057
"2905",2007,"Floyd",16497,31542,520354,4325,150,0.0285,4.36,177325,15912,8274,7638,167918,16935,22516,13501,22688,62174,8199,7927,76152,3724,1705,2221,-202,193237,167918,25319,3724,29043,5461,0,23582,5924,991,30497,115151
"2906",2007,"Franklin",10759,36518,392902,4329,151,0.0285,4.36,335439,17593,9465,8128,280946,60530,57423,16474,28728,181401,9897,13031,94863,10726,5751,5392,-417,353032,280946,72086,10726,82812,15168,0,67644,8509,1384,77537,154038
"2907",2007,"Fremont",7642,34658,264854,3478,127,0.0285,4.36,97732,12615,5915,6700,74664,2326,2122,8003,12920,11394,4027,4681,40585,-898,240,-1051,-87,110347,74664,35683,-898,34785,6694,0,28091,3034,499,31624,86338
"2908",2007,"Greene",9548,34545,329840,4235,148,0.0285,4.36,214762,16744,8561,8183,192353,17356,45438,15733,26888,74544,7424,7538,71976,3440,1373,2289,-222,231506,192353,39153,3440,42593,8441,0,34152,4595,753,39500,140218
"2909",2007,"Grundy",12317,37582,462899,4985,176,0.0285,4.36,237312,19723,8051,11672,211011,27770,30051,13967,28231,76334,8917,13257,88818,3073,2317,1019,-263,257035,211011,46024,3073,49097,8626,0,40471,8178,1314,49963,160978
"2910",2007,"Guthrie",11116,35810,398069,3675,140,0.0285,4.36,199492,12302,8444,3858,166969,21088,28325,11050,17443,105583,7161,10589,71313,2281,1607,863,-189,211794,166969,44825,2281,47106,11745,0,35361,8240,1331,44932,93909
"2911",2007,"Hamilton",15987,35968,575023,4934,154,0.0285,4.36,335288,20512,9127,11385,290389,67839,46883,14919,25566,179894,11726,16602,106854,8781,4354,4863,-436,355800,290389,65411,8781,74192,11262,0,62930,13706,2185,78821,155394
"2912",2007,"Hancock",11580,35336,409193,4381,170,0.0285,4.36,295487,17267,9481,7786,255612,45041,35483,18495,31147,142667,9427,11059,104960,7053,3100,4304,-351,312754,255612,57142,7053,64195,18696,0,45499,7929,1284,54712,152820
"2913",2007,"Hardin",17789,35564,632640,4482,169,0.0285,4.36,394386,21192,8742,12450,329418,91460,66166,14253,23277,254195,9544,15101,109617,13040,8650,4911,-521,415578,329418,86160,13040,99200,12398,NA,86801,12313,2013,101127,140191
"2914",2007,"Harrison",15177,33769,512515,3773,154,0.0285,4.36,142795,14121,7985,6136,121159,5706,8463,12749,22293,23511,6521,5644,59783,1326,594,885,-153,156916,121159,35757,1326,37083,3492,0,33591,3273,533,37397,119284
"2915",2007,"Henry",20359,30166,614157,3668,144,0.0285,4.36,124135,10646,7450,3196,113739,19510,14501,6893,14002,53933,5324,5060,48449,1732,1066,820,-154,134781,113739,21042,1732,22774,4570,0,18204,3283,543,22030,70202
"2916",2007,"Howard",9636,32172,310006,3400,134,0.0285,4.36,177042,14831,7992,6839,166983,27785,19291,10923,18359,84320,8106,7012,75507,3866,2415,1685,-234,191873,166983,24890,3866,28756,3171,0,25585,5583,925,32093,92722
"2917",2007,"Humboldt",9935,34566,343418,4689,155,0.0285,4.36,158667,14072,7405,6667,142825,15233,13848,11916,22122,44470,6758,4220,68728,2853,1202,1836,-185,172739,142825,29914,2853,32767,3474,0,29293,2892,470,32655,114197
"2918",2007,"Ida",7228,37489,270973,4426,165,0.0285,4.36,167452,14828,6418,8410,145659,16940,24378,11337,20174,66925,6326,7204,59300,2373,1656,898,-181,182280,145659,36621,2373,38994,6038,0,32956,4945,796,38697,100527
"2919",2007,"Iowa",16308,35007,570902,3785,157,0.0285,4.36,180735,16946,9227,7719,176749,20360,29020,11096,21020,81191,9107,10227,75919,2973,1602,1575,-204,197681,176749,20932,2973,23905,3832,0,20073,7136,1225,28434,99544
"2920",2007,"Jackson",20015,29936,599170,3501,161,0.0285,4.36,140808,14565,8718,5847,148419,14482,35216,7198,13994,84868,7192,7987,62350,3428,1460,2102,-134,155373,148419,6954,3428,10382,1449,0,8933,5554,931,15418,55940
"2921",2007,"Jasper",37167,31353,1165295,3929,152,0.0285,4.36,256895,16153,9304,6849,195074,24786,18246,17701,30347,74255,9279,7849,86866,3539,2434,1393,-288,273048,195074,77974,3539,81513,12981,0,68532,6089,995,75616,182640
"2922",2007,"Jefferson",16600,32346,536941,2811,115,0.0285,4.36,68040,11228,6842,4386,72230,8612,7793,4879,9805,28045,3648,2891,34602,1580,800,869,-89,79268,72230,7038,1580,8618,1454,0,7164,1933,332,9429,39995
"2923",2007,"Johnson",124541,37623,4685645,4579,163,0.0285,4.36,192817,18905,7650,11255,174186,22950,19043,11490,22775,85666,9842,12157,75929,3196,2061,1358,-223,211722,174186,37536,3196,40732,7186,0,33546,7244,1184,41974,107151
"2924",2007,"Jones",20803,27567,573472,3719,179,0.0285,4.36,194209,16911,8533,8378,189889,18804,38892,12090,23804,88520,9398,8817,78084,5971,1774,4409,-212,211120,189889,21231,5971,27202,5621,0,21581,5718,1004,28303,105689
"2925",2007,"Keokuk",10688,30388,324785,3262,152,0.0285,4.36,148011,17544,10863,6681,141694,21352,17996,9099,18307,60639,7033,5026,62881,3553,2059,1681,-187,165555,141694,23861,3553,27414,4306,0,23108,3193,520,26821,87372
"2926",2007,"Kossuth",15878,39602,628798,4537,150,0.0285,4.36,479423,27522,16106,11416,409696,65386,79335,27837,47506,222165,16678,17988,154966,11629,7258,4909,-538,506945,409696,97249,11629,108878,18597,NA,90280,12858,2075,105213,257258
"2927",2007,"Lee",36130,29667,1071874,3602,115,0.0285,4.36,88694,8328,5427,2901,87461,5273,5145,8015,15511,24645,5743,4396,43378,1172,715,569,-112,97022,87461,9561,1172,10733,2472,0,8261,3154,562,11977,64049
"2928",2007,"Linn",205840,38948,8017069,4638,162,0.0285,4.36,166061,17383,8091,9292,165402,14636,15164,13811,27377,47619,9368,10866,74180,3937,1629,2522,-214,183444,165402,18042,3937,21979,3881,0,18098,7477,1204,26779,118442
"2929",2007,"Louisa",11892,31174,370722,3997,152,0.0285,4.36,107182,9238,6322,2916,98664,15314,12897,6515,12430,44988,3885,6060,41563,2839,1469,1498,-128,116420,98664,17756,2839,20595,5013,0,15582,4449,707,20738,62194
"2930",2007,"Lucas",9280,26377,244777,2098,95,0.0285,4.36,33533,5543,4132,1411,38661,5652,4733,1722,3551,17950,2097,1645,19261,325,563,-194,NA,39076,38661,415,325,740,NA,0,696,1042,181,1919,15583
"2931",2007,"Lyon",11536,34019,392447,4458,150,0.0285,4.36,445463,18136,6885,11251,401056,89722,128463,15244,21731,329245,10711,19318,115867,6356,6830,NA,-463,463599,401056,62543,6356,68899,15443,NA,53455,13845,2264,69564,116218
"2932",2007,"Madison",15418,34274,528431,3316,133,0.0285,4.36,113390,8597,4955,3642,90955,12277,5498,6741,11145,46967,4324,7845,43125,294,922,-513,-115,121987,90955,31032,294,31326,6921,0,24405,5898,948,31251,66423
"2933",2007,"Mahaska",22388,32257,722159,3547,131,0.0285,4.36,210122,16947,9112,7835,189701,30887,45626,9598,16028,125053,8007,9272,70283,3665,2960,923,-218,227069,189701,37368,3665,41033,9082,0,31951,6296,1040,39287,85069
"2934",2007,"Marion",33279,32932,1095938,3555,143,0.0285,4.36,93978,10784,6022,4762,80652,7656,6342,7479,11644,25975,4136,4323,39072,654,542,213,-101,104762,80652,24110,654,24764,4140,0,20624,2824,464,23912,68003
"2935",2007,"Marshall",39875,33414,1332372,4103,166,0.0285,4.36,192971,15154,8300,6854,166598,15980,13026,14586,26661,49555,8504,11967,75874,2509,1541,1184,-216,208125,166598,41527,2509,44036,9286,0,34750,8102,1325,44177,143416
"2936",2007,"Mills",15239,39596,603403,3827,122,0.0285,4.36,71982,8437,4781,3656,57250,603,962,7402,11785,4061,3153,3771,29574,-1004,128,-1059,-73,80419,57250,23169,-1004,22165,3489,0,18676,1957,382,21015,67921
"2937",2007,"Mitchell",10812,32850,355177,4235,149,0.0285,4.36,241934,14609,6735,7874,221084,37504,39998,13585,23518,125696,9084,9745,87650,5595,3311,2566,-282,256543,221084,35459,5595,41054,4815,0,36239,6797,1124,44160,116238
"2938",2007,"Monona",9423,31186,293870,3452,159,0.0285,4.36,154046,13963,7093,6870,132580,6519,15439,13384,25224,29367,6885,5074,60055,1204,531,841,-168,168009,132580,35429,1204,36633,3074,0,33559,3065,501,37125,124679
"2939",2007,"Monroe",7877,32929,259385,2454,122,0.0285,4.36,46630,6526,3687,2839,49102,3601,4504,2955,7028,19831,3088,2048,25878,363,487,-69,-55,53156,49102,4054,363,4417,270,0,4147,1311,216,5674,26799
"2940",2007,"Montgomery",10981,31796,349150,3167,133,0.0285,4.36,113189,11217,5522,5695,91937,10956,6671,7649,12138,42440,4702,9620,40201,-663,609,-1155,-117,124406,91937,32469,-663,31806,4883,0,26923,7635,1215,35773,70749
"2941",2007,"Muscatine",42325,35920,1520303,4183,163,0.0285,4.36,116816,10054,6169,3885,113609,11015,8758,9083,18049,35433,5552,5596,55556,2791,769,2166,-144,126870,113609,13261,2791,16052,3354,0,12698,3777,629,17104,81383
"2942",2007,"O'Brien",14421,35456,511306,5306,164,0.0285,4.36,361359,16139,8065,8074,323514,72171,96437,15564,26532,226323,8934,9613,94263,4416,5267,-428,-423,377498,323514,53984,4416,58400,9210,0,49190,5875,952,56017,135036
"2943",2007,"Osceola",6600,36461,240645,4687,147,0.0285,4.36,293757,14671,6183,8488,235025,56387,50360,11148,18029,195161,7706,14709,76686,4746,4689,392,-335,308428,235025,73403,4746,78149,18406,0,59743,10912,1755,72410,98596
"2944",2007,"Page",16256,30280,492231,2823,132,0.0285,4.36,91544,11082,6372,4710,81974,4340,6389,7691,13859,18355,4298,4821,40576,-1411,482,-1795,-98,102626,81974,20652,-1411,19241,1948,0,17293,2922,475,20690,73189
"2945",2007,"Palo Alto",9577,34943,334648,4392,146,0.0285,4.36,339995,19938,8979,10959,282307,64502,61417,16634,28747,188730,9500,11840,89667,7769,5253,2946,-430,359933,282307,77626,7769,85395,19514,0,65881,8240,1321,75442,151265
"2946",2007,"Plymouth",24886,37198,925716,4802,147,0.0285,4.36,466133,33122,10177,22945,433843,91660,126673,19598,31707,307788,12080,14193,137932,7673,8244,NA,-533,499255,433843,65412,7673,73085,8176,NA,64908,9063,1488,75459,158345
"2947",2007,"Pocahontas",7667,34660,265739,4663,143,0.0285,4.36,223783,17639,9298,8341,185268,25957,24982,15806,29831,73220,8111,8450,72131,2902,2209,958,-265,241422,185268,56154,2902,59056,10503,0,48553,6038,982,55573,150563
"2948",2007,"Polk",413024,43190,17838411,4234,148,0.0285,4.36,122381,13227,4374,8853,106677,4214,5844,12014,18948,16318,5511,7929,52217,1461,420,1172,-131,135608,106677,28931,1461,30392,5383,0,25009,5516,904,31429,106063
"2949",2007,"Pottawattamie",91239,34454,3143571,4072,152,0.0285,4.36,297011,20047,10818,9229,250325,24700,58628,25831,30870,102994,10660,9717,89919,782,1525,-442,-301,317058,250325,66733,782,67515,22760,0,44755,6553,1088,52396,194017
"2950",2007,"Poweshiek",19140,35486,679209,3776,159,0.0285,4.36,169246,12860,8579,4281,133099,12824,9355,10427,21121,55461,6109,7801,65462,1090,921,335,-166,182106,133099,49007,1090,50097,13674,0,36423,5916,1034,43373,113785
"2951",2007,"Ringgold",5201,24951,129772,2126,137,0.0285,4.36,70350,8120,6336,1784,77050,14005,11038,3066,6594,38207,3742,3447,35158,301,1204,-810,-93,78470,77050,1420,301,1721,66,0,1655,2445,416,4516,32143
"2952",2007,"Sac",10532,36079,379988,4745,159,0.0285,4.36,381207,19852,8238,11614,344258,82012,95477,15116,24277,240068,10461,14744,102171,5754,5099,1110,-455,401059,344258,56801,5754,62555,14593,0,47962,10517,1706,60185,141139
"2953",2007,"Scott",160077,40436,6472814,5699,179,0.0285,4.36,148438,16516,6059,10457,150397,14883,11308,12438,24224,43724,7863,8451,71230,3922,1318,2799,-195,164954,150397,14557,3922,18479,4742,0,13737,5946,977,20660,104714
"2954",2007,"Shelby",12496,34537,431579,4057,146,0.0285,4.36,213266,12306,8092,4214,193176,22767,31914,14876,27712,72683,8075,11200,76632,1529,1487,285,-243,225572,193176,32396,1529,33925,2703,0,31222,8104,1304,40630,140583
"2955",2007,"Sioux",33150,32909,1090947,5204,177,0.0285,4.36,1083841,38847,10886,27961,994392,253487,380311,24212,36848,902257,21537,43016,234981,13910,13764,1320,-1174,1122688,994392,128296,13910,142206,40625,NA,101580,28553,4734,134867,181584
"2956",2007,"Story",86540,33876,2931629,4852,159,0.0285,4.36,201610,23590,7972,15618,165240,11547,10854,15996,29786,38901,8281,15015,73761,3917,756,3375,-214,225200,165240,59960,3917,63877,12008,0,51869,6472,1068,59409,162709
"2957",2007,"Tama",18064,30963,559312,4123,163,0.0285,4.36,233670,19381,11210,8171,185244,15906,23631,14338,30800,67082,8885,9989,81695,2423,1535,1118,-230,253051,185244,67807,2423,70230,12108,0,58122,6289,1010,65421,166588
"2958",2007,"Taylor",6448,31029,200078,2435,143,0.0285,4.36,123423,11699,7698,4001,100942,14337,13440,5033,8542,68620,4912,9070,45608,302,1241,-822,-117,135122,100942,34180,302,34482,1296,0,33186,6693,1073,40952,54803
"2959",2007,"Union",12319,29464,362966,2622,152,0.0285,4.36,93600,7973,4757,3216,90328,15348,18797,3723,6289,55242,3438,4284,38449,1102,1426,-226,-98,101573,90328,11245,1102,12347,1144,0,11203,2998,485,14686,38358
"2960",2007,"Van Buren",7690,26351,202640,2642,115,0.0285,4.36,93735,7117,4872,2245,81026,18598,14049,3824,8040,51146,3392,3227,29896,918,1022,NA,-116,100852,81026,19826,918,20744,6403,0,14341,2200,366,16907,42589
"2961",2007,"Wapello",35458,29728,1054089,2719,115,0.0285,4.36,56519,6717,4679,2038,61491,5226,5771,4028,8434,17312,3553,2768,31711,1346,583,833,-70,63236,61491,1745,1346,3091,440,0,2651,1961,316,4928,39207
"2962",2007,"Warren",44868,36090,1619277,3588,147,0.0285,4.36,76524,10135,5713,4422,76835,4816,4443,6003,9826,18113,4226,3760,43761,201,596,-314,-81,86659,76835,9824,201,10025,1354,0,8671,2164,359,11194,58411
"2963",2007,"Washington",21588,35759,771964,4289,162,0.0285,4.36,278611,22722,11935,10787,253044,59908,44772,10670,20336,181513,9783,10125,97450,7090,5794,1642,-346,301333,253044,48289,7090,55379,19626,0,35753,6169,1021,42943,97098
"2964",2007,"Wayne",6376,25185,160581,1947,125,0.0285,4.36,56116,9710,6861,2849,59342,3482,3660,4200,8525,14806,3203,2412,33860,-450,481,-868,-63,65826,59342,6484,-450,6034,360,0,5674,1286,288,7248,41310
"2965",2007,"Webster",38393,32900,1263132,4779,151,0.0285,4.36,275746,17184,11181,6003,230708,30475,18181,19263,35123,84206,10038,11394,106234,4928,1798,3445,-315,292930,230708,62222,4928,67150,8827,0,58323,7747,1265,67335,191540
"2966",2007,"Winnebago",10986,32721,359473,4054,140,0.0285,4.36,179706,13426,7709,5717,157385,33060,16836,10941,18154,76599,6581,11429,60384,4131,1685,2679,-233,193132,157385,35747,4131,39878,9763,0,30115,8674,1416,40205,103107
"2967",2007,"Winneshiek",21078,33409,704186,3413,157,0.0285,4.36,207155,23750,10755,12995,211380,28382,26078,10679,19128,133388,10513,14439,102161,4960,1783,3407,-230,230905,211380,19525,4960,24485,1645,0,22840,9699,1614,34153,73767
"2968",2007,"Woodbury",100492,32428,3258777,3570,140,0.0285,4.36,238467,24417,10401,14016,219139,23566,40803,16825,28714,97226,8309,10031,90891,3875,1505,2626,-256,262884,219139,43745,3875,47620,4919,0,42701,6688,1098,50487,141241
"2969",2007,"Worth",7655,30934,236801,4162,138,0.0285,4.36,105966,10807,6406,4401,94396,3995,4009,9963,18720,15167,6120,2709,48880,1826,388,1563,-125,116773,94396,22377,1826,24203,1940,0,22263,1340,233,23836,90799
"2970",2007,"Wright",13492,40333,544173,4807,156,0.0285,4.36,421031,15326,10441,4885,332367,80429,40682,13473,24046,279642,9227,21251,143259,8548,6256,2765,-473,436357,332367,103990,8548,112538,22112,NA,90425,16778,2737,109940,141389
"2971",2008,"Adair",7747,37196,288155,3400,148,0.0385,1.37,174383,13829,7484,6345,139114,15724,16822,9956,22741,64770,6407,7761,59703,2031,-406,1859,578,188212,139114,49098,2031,51129,9250,0,41879,4942,792,47613,109613
"2972",2008,"Adams",4151,35734,148330,2770,170,0.0385,1.37,91431,9793,5803,3990,83499,11814,12583,5372,10310,34317,4954,3782,34684,697,-226,578,345,101224,83499,17725,697,18422,1239,0,17183,2302,507,19992,57114
"2973",2008,"Allamakee",14325,31423,450130,2931,160,0.0385,1.37,157015,15812,7564,8248,147542,25890,17970,6473,13946,108603,8394,9335,65534,766,-457,633,590,172827,147542,25285,766,26051,1152,0,24899,5839,954,31692,48412
"2974",2008,"Appanoose",12950,27483,355908,2089,126,0.0385,1.37,38647,7019,4175,2844,45691,2510,2294,3117,7650,13088,3184,1866,25070,1790,-331,1951,170,45666,45691,NA,1790,1765,73,0,1692,739,129,2560,25559
"2975",2008,"Audubon",6200,43418,269191,4720,164,0.0385,1.37,252932,15559,7911,7648,198046,42276,38455,12583,20120,119006,8678,9140,66794,1446,197,341,908,268491,198046,70445,1446,71891,5976,0,65915,6284,921,73120,133926
"2976",2008,"Benton",26097,38598,1007303,5192,185,0.0385,1.37,328476,23597,10571,13026,250118,21146,38917,17088,40752,119235,11691,13578,106946,917,-446,414,949,352073,250118,101955,917,102872,18698,0,84174,6574,1034,91782,209241
"2977",2008,"Black Hawk",129203,35627,4603109,5818,208,0.0385,1.37,217719,16423,7264,9159,182242,24437,17256,14893,29226,63753,11789,9211,75430,783,145,-210,848,234142,182242,51900,783,52683,10057,0,42626,5300,812,48738,153966
"2978",2008,"Boone",26454,38202,1010596,5497,170,0.0385,1.37,206350,20396,8048,12348,163627,9625,11330,17142,34375,41717,10328,10093,70734,-877,-107,-1508,738,226746,163627,63119,-877,62242,21397,0,40845,6409,973,48227,164633
"2979",2008,"Bremer",24162,37812,913610,5180,183,0.0385,1.37,186963,12669,6408,6261,166429,25559,18403,13243,28050,70685,9384,5422,66368,60,NA,-752,809,199632,166429,33203,60,33263,4035,0,29228,2816,456,32500,116278
"2980",2008,"Buchanan",21154,32877,695490,5096,208,0.0385,1.37,307479,21795,8410,13385,269356,45387,32761,18964,39667,126033,14024,9106,109447,-303,102,-1726,1321,329274,269356,59918,-303,59615,7954,0,51661,5947,977,58585,181446
"2981",2008,"Buena Vista",19855,37329,741172,5582,186,0.0385,1.37,469836,30200,10182,20018,361622,113253,79536,18645,34516,268783,12328,11120,92224,2767,647,145,1975,500036,361622,138414,2767,141181,30090,0,111091,6535,1011,118637,201053
"2982",2008,"Butler",14957,37411,559563,5016,212,0.0385,1.37,310894,19809,9032,10777,241731,50418,31077,16160,34105,120911,11158,10551,88262,341,420,-1353,1274,330703,241731,88972,341,89313,7915,0,81398,6587,1103,89088,189983
"2983",2008,"Calhoun",9845,41906,412564,5691,169,0.0385,1.37,340239,19005,10367,8638,251224,48352,48482,17158,36276,130906,12479,8176,80301,295,430,-1362,1227,359244,251224,108020,295,108315,14260,0,94055,5081,788,99924,209333
"2984",2008,"Carroll",20742,40034,830390,5179,196,0.0385,1.37,514378,23041,8569,14472,448716,118347,137507,16339,32134,327588,14270,14562,115557,NA,-68,-1901,2005,537419,448716,88703,NA,88739,9778,NA,78962,9620,1547,90129,186790
"2985",2008,"Cass",13935,38804,540738,4174,158,0.0385,1.37,221949,17218,8239,8979,160717,19982,26556,12236,20965,89056,8384,8476,64118,547,-395,290,652,239167,160717,78450,547,78997,8036,0,70961,4663,734,76358,132893
"2986",2008,"Cedar",18460,38509,710874,4934,171,0.0385,1.37,245861,28912,11315,17597,215181,21989,24596,17454,40145,70837,11551,11325,88121,-202,NA,-1151,955,274773,215181,59592,-202,59390,12037,0,47353,6092,989,54434,175024
"2987",2008,"Cerro Gordo",44285,38385,1699883,5029,200,0.0385,1.37,224762,23563,9159,14404,176020,14598,11231,20169,40085,46243,10603,6719,72615,-1454,160,-2502,888,248325,176020,72305,-1454,70851,6727,0,64124,3127,512,67763,178519
"2988",2008,"Cherokee",12014,41285,495998,5234,183,0.0385,1.37,338608,28529,7806,20723,257923,53729,61155,14853,27115,165629,11528,8861,80682,1611,-399,880,1130,367137,257923,109214,1611,110825,14500,0,96325,4169,692,101186,172979
"2989",2008,"Chickasaw",12471,36035,449389,4236,165,0.0385,1.37,263111,19799,7464,12335,239896,38610,43198,13971,31154,136436,12526,11852,88585,512,-121,-397,1030,282910,239896,43014,512,43526,7086,0,36440,6075,981,43496,126675
"2990",2008,"Clarke",9217,29561,272466,2290,164,0.0385,1.37,60228,7116,4002,3114,56787,14585,5927,2307,4338,41555,2824,2115,24691,1249,-187,1172,264,67344,56787,10557,1249,11806,533,0,11273,955,157,12385,18673
"2991",2008,"Clay",16697,41172,687444,5189,173,0.0385,1.37,337563,20793,8894,11899,252315,49493,52899,17072,30892,160602,9869,15240,76850,1377,99,119,1159,358356,252315,106041,1377,107418,22528,0,84890,8738,1276,94904,176961
"2992",2008,"Clayton",18209,32556,592809,4008,183,0.0385,1.37,273115,31153,11376,19777,264619,44621,34917,15285,29408,155535,14394,12158,113836,213,-528,-372,1113,304268,264619,39649,213,39862,5006,0,34856,6739,1221,42816,117580
"2993",2008,"Clinton",49303,35553,1752888,4208,193,0.0385,1.37,281968,28196,11953,16243,239759,17331,27372,20337,48187,80727,13534,10595,102403,-1165,-520,-1677,1032,310164,239759,70405,-1165,69240,8253,0,60987,5887,1039,67913,201241
"2994",2008,"Crawford",16881,37548,633854,4750,168,0.0385,1.37,358044,28170,8833,19337,271251,48226,51291,19555,41026,128801,10824,9432,90897,840,108,-503,1235,386214,271251,114963,840,115803,5729,0,110074,5495,886,116455,229243
"2995",2008,"Dallas",62144,44824,2785524,5077,177,0.0385,1.37,246845,25836,6750,19086,189591,16612,21262,14660,26157,101923,8330,24868,77702,615,-56,NA,690,272681,189591,83090,615,83705,8918,0,74787,15966,2267,93020,144922
"2996",2008,"Davis",8675,25395,220300,2675,138,0.0385,1.37,71049,10956,5774,5182,86031,16817,8263,3997,9827,38822,4725,3441,38961,2268,-280,2166,382,82005,86031,-4026,2268,-1758,-649,0,-1109,2047,339,1277,32227
"2997",2008,"Decatur",8457,24399,206342,2002,134,0.0385,1.37,60235,15128,4586,10542,70773,12140,9465,3126,7000,34727,3702,2779,32561,1196,-466,1382,280,75363,70773,4590,1196,5786,454,0,5332,1680,292,7304,25508
"2998",2008,"Delaware",17840,34275,611466,5152,210,0.0385,1.37,363268,27323,9669,17654,361007,61123,75506,16292,33263,244760,17106,11732,145985,-1794,-654,-2591,1451,390591,361007,29584,-1794,27790,1993,0,25797,6614,1256,33667,118508
"2999",2008,"Des Moines",40235,36389,1464125,4380,179,0.0385,1.37,96758,13181,5029,8152,74815,4307,2824,8613,18339,19075,4729,3075,32928,293,NA,-80,371,109939,74815,35124,293,35417,6062,0,29355,1180,193,30728,77683
"3000",2008,"Dickinson",16690,42870,715495,4879,165,0.0385,1.37,159835,12283,4967,7316,128832,11831,22808,11292,21421,45151,6244,6810,48426,465,-281,223,523,172118,128832,43286,465,43751,6308,0,37443,3469,514,41426,114684
"3001",2008,"Dubuque",92519,36338,3361918,4705,232,0.0385,1.37,297860,23493,8198,15295,285214,53515,60048,12076,25914,219078,15416,12418,105827,-778,-1186,-750,1158,321353,285214,36139,-778,35361,1900,0,33461,6840,1213,41514,78782
"3002",2008,"Emmet",10448,34439,359816,5199,154,0.0385,1.37,245638,12875,6312,6563,209325,43676,44753,12830,28430,117363,7434,6143,66059,416,-97,-486,999,258513,209325,49188,416,49604,8359,0,41245,3618,554,45417,128275
"3003",2008,"Fayette",20910,31608,660919,4633,194,0.0385,1.37,350871,32349,12529,19820,305816,57607,33739,18822,37619,175329,15686,13432,128911,255,-212,-956,1423,383220,305816,77404,255,77659,11872,0,65787,8062,1285,75134,175542
"3004",2008,"Floyd",16331,34570,564556,4893,166,0.0385,1.37,214769,21529,8462,13067,187169,21317,23464,15773,29627,68996,10347,7703,78938,68,87,-830,811,236298,187169,49129,68,49197,8905,0,40292,5219,865,46376,145773
"3005",2008,"Franklin",10690,39482,422065,4934,190,0.0385,1.37,394417,23423,9518,13905,321524,76424,62933,19335,37689,201560,12543,13838,98762,-329,1073,-3077,1675,417840,321524,96316,-329,95987,16189,0,79798,7450,1170,88418,192857
"3006",2008,"Fremont",7489,39050,292443,3954,173,0.0385,1.37,112758,18549,7064,11485,83310,2928,2154,9350,16873,12509,5082,4867,42056,1167,-152,968,351,131307,83310,47997,1167,49164,9211,0,39953,2663,427,43043,100249
"3007",2008,"Greene",9415,39776,374495,4973,181,0.0385,1.37,255309,22393,8389,14004,215422,21847,48074,18380,35111,82801,9370,8031,74609,-70,-111,-850,891,277702,215422,62280,-70,62210,11367,0,50843,4032,644,55519,172508
"3008",2008,"Grundy",12359,43446,536948,5787,224,0.0385,1.37,300364,27967,7960,20007,236982,34954,31481,16319,36866,85209,11253,14020,92089,1680,290,333,1057,328331,236982,91349,1680,93029,16070,0,76959,7142,1092,85193,215155
"3009",2008,"Guthrie",11038,40408,446029,4362,158,0.0385,1.37,258138,15294,8718,6576,187805,26545,32602,12909,22779,128092,9038,10018,73914,568,-78,-114,760,273432,187805,85627,568,86195,18760,0,67435,7202,1112,75749,130046
"3010",2008,"Hamilton",15863,39939,633552,5735,191,0.0385,1.37,396381,29086,9583,19503,336154,86725,54084,17729,33962,208523,15047,15920,112687,425,903,-2228,1750,425467,336154,89313,425,89738,12943,0,76795,11953,1801,90549,187858
"3011",2008,"Hancock",11525,38282,441195,4971,190,0.0385,1.37,368279,22686,9375,13311,290755,56694,40189,21608,40673,170508,11896,10930,108765,51,510,-1867,1408,390965,290755,100210,51,100261,26078,0,74183,6937,1079,82199,197771
"3012",2008,"Hardin",17690,38793,686250,5210,200,0.0385,1.37,462294,29963,8631,21332,386292,117759,76629,17060,31143,291664,12335,14927,116439,1589,1546,-2052,2095,492257,386292,105965,1589,107554,13046,0,94508,10793,1711,107012,170630
"3013",2008,"Harrison",14946,38697,578360,4437,172,0.0385,1.37,189317,20120,9616,10504,136457,7183,8952,14894,29112,26801,8230,6124,61962,-1441,-204,-1850,613,209437,136457,72980,-1441,71539,6664,0,64875,2867,450,68192,162516
"3014",2008,"Henry",20307,32531,660614,4121,155,0.0385,1.37,153958,13151,7695,5456,128356,24558,15245,8053,18284,59895,6719,5258,50239,880,NA,235,619,167109,128356,38753,880,39633,7341,0,32292,2884,465,35641,94063
"3015",2008,"Howard",9625,33991,327167,3823,159,0.0385,1.37,209732,19357,7656,11701,192745,35961,20814,13141,24689,91647,10530,7019,80591,448,96,-587,939,229089,192745,36344,448,36792,4051,0,32741,4909,799,38449,118085
"3016",2008,"Humboldt",9911,39489,391380,5390,178,0.0385,1.37,200819,18845,7439,11406,160667,19175,14574,13922,28888,49887,8531,4263,71314,466,NA,-314,742,219664,160667,58997,466,59463,5879,0,53584,2532,397,56513,150932
"3017",2008,"Ida",7215,47449,342341,5244,197,0.0385,1.37,231746,21030,6618,14412,164306,21324,26657,13245,26345,78464,7984,7282,61469,-65,-346,-448,729,252776,164306,88470,-65,88405,13384,0,75021,4318,660,79999,153282
"3018",2008,"Iowa",16337,38321,626044,4356,192,0.0385,1.37,214105,22986,9783,13203,197022,25627,30477,12962,27449,90919,11493,10329,78685,529,-404,112,821,237091,197022,40069,529,40598,6292,0,34306,6331,1111,41748,123186
"3019",2008,"Jackson",19919,32340,644186,3882,189,0.0385,1.37,166316,18924,8937,9987,159515,18117,33704,8370,18191,93640,9032,7778,64323,195,-899,557,537,185240,159515,25725,195,25920,3331,0,22589,4895,816,28300,72676
"3020",2008,"Jasper",37103,32736,1214587,4487,174,0.0385,1.37,325915,20891,9192,11699,222307,31397,19850,20842,39943,82355,11799,7750,90726,1967,64,747,1156,346806,222307,124499,1967,126466,17900,0,108566,5336,843,114745,243560
"3021",2008,"Jefferson",16607,32702,543078,3159,142,0.0385,1.37,81537,14574,7072,7502,80315,10839,7520,5700,12804,28914,4604,2978,35870,657,-64,362,359,96111,80315,15796,657,16453,2624,0,13829,1713,298,15840,52623
"3022",2008,"Johnson",127113,39907,5072677,5155,175,0.0385,1.37,226580,28052,8773,19279,196151,28887,19864,13424,29741,95076,12421,13077,78737,1362,-117,583,896,254632,196151,58481,1362,59843,10039,0,49804,6353,1008,57165,131504
"3023",2008,"Jones",20848,30395,633665,4121,189,0.0385,1.37,228638,23231,8898,14333,211184,23668,40284,14124,31085,98144,11860,9226,80937,-1391,-528,-1714,851,251869,211184,40685,-1391,39294,8041,0,31253,5094,929,37276,130494
"3024",2008,"Keokuk",10620,34138,362544,3703,175,0.0385,1.37,174543,23206,11782,11424,158998,26875,18288,10630,23907,65952,8875,5257,65166,1333,71,512,750,197749,158998,38751,1333,40084,5894,0,34190,2795,439,37424,108591
"3025",2008,"Kossuth",15685,45634,715771,5164,182,0.0385,1.37,585540,35711,16193,19518,466598,83800,83612,33063,63065,247402,21385,18246,163427,1387,1196,-1970,2161,621251,466598,154653,1387,156040,24691,NA,131350,11238,1732,144320,338138
"3026",2008,"Lee",35819,31845,1140642,3998,179,0.0385,1.37,106578,10960,6008,4952,97905,6636,5038,9364,20256,25912,7246,4412,44953,566,-128,244,450,117538,97905,19633,566,20199,4492,0,15707,2821,532,19060,80666
"3027",2008,"Linn",208558,41208,8594345,5196,167,0.0385,1.37,203452,24234,8337,15897,185411,18424,15435,16136,35752,52256,11822,10959,76883,709,-145,NA,858,227686,185411,42275,709,42984,6899,0,36085,6531,1002,43618,151196
"3028",2008,"Louisa",11830,32297,382078,4498,179,0.0385,1.37,128188,11430,6450,4980,110773,19277,13754,7611,16233,51004,4904,5904,43090,294,230,-450,514,139618,110773,28845,294,29139,6694,0,22445,3878,581,26904,77184
"3029",2008,"Lucas",9137,27306,249491,2297,164,0.0385,1.37,36330,6361,3964,2397,42762,7114,4647,2012,4637,19423,2647,1738,19967,828,-406,1058,176,42691,42762,-71,828,757,NA,0,713,926,166,1805,16907
"3030",2008,"Lyon",11545,40138,463397,5167,184,0.0385,1.37,528796,26820,7567,19253,430973,109903,127981,17307,27574,361880,13128,18322,116758,633,-433,-793,1859,555616,430973,124643,633,125276,26677,NA,98600,12138,1926,112664,166916
"3031",2008,"Madison",15517,37080,575375,3763,156,0.0385,1.37,140218,11358,5141,6217,101996,15452,6391,7875,14554,58085,5458,7563,44703,1663,-314,1516,461,151576,101996,49580,1663,51243,10540,0,40703,5152,788,46643,82133
"3032",2008,"Mahaska",22483,34764,781595,3987,170,0.0385,1.37,251369,22709,9302,13407,211817,38878,48408,11213,20929,140991,10105,9427,72857,792,158,-243,877,274078,211817,62261,792,63053,13726,0,49327,5530,891,55748,110378
"3033",2008,"Marion",33515,34532,1157328,3943,170,0.0385,1.37,110751,13925,5789,8136,90180,9638,6408,8736,15204,28045,5219,4480,40495,1591,-199,1383,407,124676,90180,34496,1591,36087,5774,0,30313,2479,399,33191,82706
"3034",2008,"Marshall",40151,35246,1415156,4768,192,0.0385,1.37,234023,20128,8401,11727,186912,20114,13358,17041,34815,54440,10733,12185,78666,996,NA,162,867,254151,186912,67239,996,68235,14327,0,53908,7102,1127,62137,179583
"3035",2008,"Mills",15214,42763,650603,4351,138,0.0385,1.37,90858,11339,5082,6257,64571,759,818,8647,15389,3803,3980,4335,30643,953,-89,749,293,102197,64571,37626,953,38579,5942,0,32637,1789,391,34817,87055
"3036",2008,"Mitchell",10815,39132,423216,4791,172,0.0385,1.37,291222,20331,6860,13471,247550,47207,41671,15872,30710,139986,11464,9794,90832,-1030,-166,-1998,1134,311553,247550,64003,-1030,62973,6669,0,56304,5972,968,63244,151236
"3037",2008,"Monona",9350,37249,348279,4139,197,0.0385,1.37,217119,20332,8571,11761,160164,8758,17964,16706,35194,34251,9279,5796,66467,NA,-189,-518,676,237451,160164,77287,NA,77256,6365,0,70891,2686,425,74002,182868
"3038",2008,"Monroe",7904,34376,271704,2732,126,0.0385,1.37,49691,8655,3804,4851,54390,4531,4362,3453,9178,20883,3899,2141,26826,1241,-310,1332,219,58346,54390,3956,1241,5197,297,0,4900,1151,187,6238,28808
"3039",2008,"Montgomery",10823,35491,384121,3600,147,0.0385,1.37,141459,15505,5751,9754,102831,13790,7669,8936,15852,51704,5935,8974,41675,518,-301,348,471,156964,102831,54133,518,54651,8248,0,46403,6652,995,54050,89755
"3040",2008,"Muscatine",42515,37103,1577428,4671,200,0.0385,1.37,138392,13943,7312,6631,127611,13865,9248,10611,23569,39812,7007,5723,57588,-451,-96,-933,578,152335,127611,24724,-451,24273,4756,0,19517,3323,546,23386,98580
"3041",2008,"O'Brien",14332,40862,585630,6149,185,0.0385,1.37,451668,22130,8319,13811,364884,90844,102017,18183,34648,254151,11275,10211,97706,2337,168,468,1701,473798,364884,108914,2337,111251,17215,0,94036,5142,800,99978,197517
"3042",2008,"Osceola",6617,40936,270875,5432,178,0.0385,1.37,347147,20829,6293,14536,274349,74004,54227,13558,24512,215584,10119,15143,82786,1864,535,NA,1344,367976,274349,93627,1864,95491,21071,0,74420,9532,1461,85413,131563
"3043",2008,"Page",16083,31845,512161,3209,160,0.0385,1.37,103027,14626,6573,8053,91028,5463,5851,8985,18098,18294,5424,5146,42061,1476,-262,1345,393,117653,91028,26625,1476,28101,2675,0,25426,2558,401,28385,84733
"3044",2008,"Palo Alto",9486,40958,388532,5025,166,0.0385,1.37,424979,28077,9302,18775,328678,82436,69282,19763,38175,215870,12188,12323,94511,1096,952,-1583,1727,453056,328678,124378,1096,125474,26318,0,99156,7193,1095,107444,209109
"3045",2008,"Plymouth",24898,41536,1034166,5691,160,0.0385,1.37,595645,52068,12731,39337,495120,119267,130666,23661,42789,338187,15750,15299,147688,3129,262,725,2142,647713,495120,152593,3129,155722,15155,NA,140568,7954,1276,149798,257458
"3046",2008,"Pocahontas",7510,43437,326215,5350,162,0.0385,1.37,290792,23672,9399,14273,209526,32673,26053,18466,38953,81167,10236,8367,74778,1530,340,126,1064,314464,209526,104938,1530,106468,17573,0,88895,5287,829,95011,209625
"3047",2008,"Polk",419495,43611,18294416,4902,196,0.0385,1.37,138990,19593,4418,15175,119183,5304,6053,14036,24744,18166,6956,7962,54128,NA,-102,-374,525,158583,119183,39400,NA,39449,6867,0,32582,4840,772,38194,120824
"3048",2008,"Pottawattamie",91781,36203,3322757,4707,179,0.0385,1.37,372748,26763,10963,15800,279591,31090,61441,30175,40311,115510,13452,9930,93192,-54,-797,-468,1211,399511,279591,119920,-54,119866,37971,0,81895,5762,939,88596,257238
"3049",2008,"Poweshiek",19025,39394,749475,4340,188,0.0385,1.37,210098,15905,8598,7307,149759,16144,10707,12183,27582,67091,7711,7583,67849,1468,-183,983,668,226003,149759,76244,1468,77712,19771,0,57941,5268,954,64163,143007
"3050",2008,"Ringgold",5164,26825,138522,2361,157,0.0385,1.37,76696,9210,6178,3032,85657,17629,11226,3581,8611,42627,4724,3447,36439,1469,-263,1357,375,85906,85657,249,1469,1718,66,0,1652,2160,367,4179,34069
"3051",2008,"Sac",10475,42766,447973,5542,181,0.0385,1.37,470728,28873,8966,19907,388217,103230,101908,17660,31702,271779,13203,14619,105895,1228,200,-800,1828,499601,388217,111384,1228,112612,23284,0,89328,9206,1440,99974,198949
"3052",2008,"Scott",161824,42969,6953445,6310,202,0.0385,1.37,189118,24627,6714,17913,168975,18735,11847,14531,31634,48966,9923,8452,73853,-478,NA,-1294,785,213745,168975,44770,-478,44292,10569,0,33723,5217,833,39773,140152
"3053",2008,"Shelby",12338,42592,525496,4783,176,0.0385,1.37,285917,15307,8116,7191,223113,29605,34074,17972,37425,79868,10536,11374,82127,NA,-272,-700,978,301224,223113,78111,NA,78117,5560,0,72557,7081,1087,80725,206049
"3054",2008,"Sioux",33364,37919,1265136,6095,188,0.0385,1.37,1289523,59688,11761,47927,1106865,317391,401517,28037,47688,1000115,26937,43713,241582,1805,-1701,-1206,4712,1349211,1106865,242346,1805,244151,64678,NA,179474,25114,4100,208688,289408
"3055",2008,"Story",87831,36031,3164663,5686,190,0.0385,1.37,236640,34889,8116,26773,188505,14535,11605,18688,38897,44113,10450,17887,76443,-323,-89,-1092,858,271529,188505,83024,-323,82701,14791,0,67910,5689,921,74520,192527
"3056",2008,"Tama",17986,35012,629724,4786,201,0.0385,1.37,296885,25450,11478,13972,208124,20021,24765,16751,40221,75104,11214,10465,84687,1594,-245,916,923,322335,208124,114211,1594,115805,17655,0,98150,5492,837,104479,221781
"3057",2008,"Taylor",6348,35198,223435,2532,174,0.0385,1.37,149016,14168,7328,6840,114952,18310,15792,5975,11335,81383,6296,9219,48025,1483,-155,1169,469,163184,114952,48232,1483,49715,1819,0,47896,5845,891,54632,67633
"3058",2008,"Union",12447,31180,388095,2909,192,0.0385,1.37,106733,10213,4720,5493,99590,19318,19215,4350,8213,60448,4339,4291,39864,1204,-256,1066,394,116946,99590,17356,1204,18560,1550,0,17010,2622,408,20040,46285
"3059",2008,"Van Buren",7699,28342,218208,2936,138,0.0385,1.37,105248,8708,4882,3826,91357,23409,14429,4469,10499,55568,4280,3288,30983,1396,-69,999,466,113956,91357,22599,1396,23995,6717,0,17278,1938,320,19536,49680
"3060",2008,"Wapello",35381,31100,1100342,3058,142,0.0385,1.37,62479,8517,5039,3478,68216,6578,5803,4705,11014,18744,4485,2753,32878,1055,-75,850,280,70996,68216,2780,1055,3835,501,0,3334,1712,262,5308,43735
"3061",2008,"Warren",45450,38220,1737080,4011,156,0.0385,1.37,85687,13278,5729,7549,85091,6061,4392,7014,12831,19550,5334,4095,45364,1213,-249,1137,325,98965,85091,13874,1213,15087,1877,0,13210,1903,311,15424,66137
"3062",2008,"Washington",21686,38569,836415,4867,175,0.0385,1.37,339242,31171,12700,18471,285750,75407,47170,12466,26556,203330,12347,10790,101014,2124,896,-164,1392,370413,285750,84663,2124,86787,28911,0,57876,5425,884,64185,135912
"3063",2008,"Wayne",6373,26835,171020,2132,164,0.0385,1.37,56338,11190,6332,4858,65662,4383,3296,4907,11133,16540,4044,2791,35108,1561,-358,1665,254,67528,65662,1866,1561,3427,198,0,3229,1219,330,4778,39798
"3064",2008,"Webster",38273,36103,1381767,5555,187,0.0385,1.37,343153,21435,11194,10241,261368,38361,20350,22502,45866,99382,12669,11562,110058,-290,242,-1798,1266,364588,261368,103220,-290,102930,12163,0,90767,6789,1073,98629,243771
"3065",2008,"Winnebago",10927,34818,380458,4600,169,0.0385,1.37,221598,17202,7423,9779,179560,41613,19540,12781,23708,93856,8305,10981,62632,NA,199,-1152,935,238800,179560,59240,NA,59222,13491,0,45731,7602,1202,54535,127742
"3066",2008,"Winneshiek",20980,36674,769431,3814,184,0.0385,1.37,239948,32509,10267,22242,233584,35725,26455,12476,24978,142982,13268,14798,105884,-63,-605,-383,925,272457,233584,38873,-63,38810,2365,0,36445,8537,1404,46386,96966
"3067",2008,"Woodbury",100910,34459,3477248,4270,189,0.0385,1.37,339824,36617,12594,24023,244406,29664,42595,19656,37497,108073,10485,10284,94225,-521,-586,-964,1029,376441,244406,132035,-521,131514,12747,0,118767,5869,939,125575,231751
"3068",2008,"Worth",7632,34710,264903,4715,161,0.0385,1.37,133638,14106,6589,7517,107050,5028,4395,11640,24445,17677,7725,3122,50695,-183,NA,-668,502,147744,107050,40694,-183,40511,3074,0,37437,1192,215,38844,115961
"3069",2008,"Wright",13375,44350,593180,5526,193,0.0385,1.37,516207,18788,10448,8340,392962,105292,50258,16396,32710,342417,12125,21600,154581,2536,1281,-645,1900,534995,392962,142033,2536,144569,26959,0,117610,14707,2327,134644,173790
"3070",2009,"Adair",7676,35144,269768,3321,159,-0.0034,0.15,158901,15087,7156,7931,134472,16505,12936,11360,21309,50098,5084,7065,60213,-6108,-863,-5309,64,173988,134472,39516,-6108,33408,4829,0,28579,5156,767,34502,108803
"3071",2009,"Adams",4047,37109,150181,2764,186,-0.0034,0.15,93016,10289,5302,4987,81254,12398,10745,6130,9662,29734,3930,3409,34980,-3907,-834,-3111,NA,103305,81254,22051,-3907,18144,975,0,17169,2399,492,20060,63282
"3072",2009,"Allamakee",14263,29659,423021,3096,157,-0.0034,0.15,136856,20973,10663,10310,143544,27171,14648,7387,13068,89098,6661,8515,66094,-4220,-1525,-2760,65,157829,143544,14285,-4220,10065,356,0,9709,6091,926,16726,47758
"3073",2009,"Appanoose",12896,27619,356172,2061,130,-0.0034,0.15,42120,7044,3490,3554,44566,2635,1848,3556,7168,10816,2527,1547,25285,-4378,-608,-3789,NA,49164,44566,4598,-4378,220,NA,0,213,772,125,1110,31304
"3074",2009,"Audubon",6136,41092,252143,4537,183,-0.0034,0.15,239545,17162,7601,9561,194511,44370,34233,14358,18854,107272,6885,8447,67364,-6126,-1916,-4310,100,256707,194511,62196,-6126,56070,3724,0,52346,6557,893,59796,132273
"3075",2009,"Benton",26117,38020,992961,4973,185,-0.0034,0.15,297485,26654,10368,16286,241060,22194,32159,19498,38188,98836,9276,11885,107860,-7624,-1378,-6350,104,324139,241060,83079,-7624,75455,10959,0,64496,6859,1001,72356,198649
"3076",2009,"Black Hawk",130595,34968,4566691,5434,221,-0.0034,0.15,201242,18772,7321,11451,179059,25647,15332,16994,27387,57307,9354,8271,76074,-3384,-916,-2561,93,220014,179059,40955,-3384,37571,5731,0,31840,5529,786,38155,143935
"3077",2009,"Boone",26360,38304,1009692,5204,179,-0.0034,0.15,208714,22887,7447,15440,160198,10102,9590,19560,32212,35590,8195,9200,71339,-3885,-625,-3341,81,231601,160198,71403,-3885,67518,18546,0,48972,6687,945,56604,173124
"3078",2009,"Bremer",24183,37626,909908,5032,190,-0.0034,0.15,179932,14697,6872,7825,162922,26825,15567,15111,26285,60314,7446,4753,66935,-3327,-922,-2494,89,194629,162922,31707,-3327,28380,2751,0,25629,2938,440,29007,119618
"3079",2009,"Buchanan",21016,32763,688553,4924,186,-0.0034,0.15,282821,25956,9219,16737,262234,47058,28843,21383,36729,112341,10992,8194,109035,-4088,-2055,-2178,145,308777,262234,46543,-4088,42455,4526,0,37929,6205,949,45083,170480
"3080",2009,"Buena Vista",20004,35785,715850,5538,185,-0.0034,0.15,422111,32957,7924,25033,351281,118862,66120,21275,32345,224850,9782,9885,93012,-7270,-2363,-5124,217,455068,351281,103787,-7270,96517,16437,NA,80079,6819,981,87879,197261
"3081",2009,"Butler",14699,37097,545292,4785,208,-0.0034,0.15,295541,22759,9286,13473,237957,52874,27546,18428,31940,108782,8847,9385,88937,-4678,-1965,-2853,140,318300,237957,80343,-4678,75665,5358,0,70307,6871,1070,78248,186759
"3082",2009,"Calhoun",9684,38624,374033,5481,202,-0.0034,0.15,300507,20158,9360,10798,245828,50747,43236,19579,33994,118004,9901,7384,80987,-5702,-1707,-4130,135,320665,245828,74837,-5702,69135,7273,0,61862,5301,762,67925,182503
"3083",2009,"Carroll",20743,38377,796045,5081,210,-0.0034,0.15,485093,26096,8001,18095,434332,124206,120047,18644,30111,288145,11324,13457,116543,-7494,-4422,-3293,221,511189,434332,76857,-7494,69363,6107,NA,63255,10033,1496,74784,196948
"3084",2009,"Cass",13949,38154,532209,4053,172,-0.0034,0.15,210127,18628,7402,11226,155388,20972,21984,13961,19646,74118,6653,7506,64666,-5899,-1237,-4734,72,228755,155388,73367,-5899,67468,5484,0,61984,4865,710,67559,136009
"3085",2009,"Cedar",18458,38062,702553,4922,194,-0.0034,0.15,237260,31113,9110,22003,210496,23078,21790,19916,37619,63570,9165,10054,88874,-4981,-1269,-3817,105,268373,210496,57877,-4981,52896,8566,0,44330,6354,959,51643,173690
"3086",2009,"Cerro Gordo",44239,37254,1648059,4811,221,-0.0034,0.15,207863,26350,8339,18011,173313,15322,9934,23014,37563,41522,8413,5831,73236,-2885,-761,-2222,98,234213,173313,60900,-2885,58015,4402,0,53613,3263,498,57374,166341
"3087",2009,"Cherokee",11953,39128,467692,5181,198,-0.0034,0.15,311033,32377,6461,25916,248238,55988,52693,16830,25232,143960,9082,7632,80781,-8030,-2639,-5515,124,343410,248238,95172,-8030,87142,9110,0,78032,4349,669,83050,167073
"3088",2009,"Chickasaw",12465,35236,439215,4245,170,-0.0034,0.15,240805,23598,8178,15420,232613,40522,37564,15941,29194,119574,9939,10111,89342,-5107,-1899,-3321,113,264403,232613,31790,-5107,26683,3471,0,23212,6338,951,30501,121231
"3089",2009,"Clarke",9228,28879,266495,2258,126,-0.0034,0.15,57155,7539,3648,3891,54071,14644,5218,2526,3902,37029,2151,1747,23883,-3017,-882,-2164,NA,64694,54071,10623,-3017,7606,275,0,7331,997,153,8481,20126
"3090",2009,"Clay",16708,38598,644899,5153,180,-0.0034,0.15,307783,22569,7692,14877,243356,51945,44376,19479,28949,135408,7831,13269,77507,-5777,-1518,-4387,128,330352,243356,86996,-5777,81219,13610,0,67609,9118,1235,77962,172375
"3091",2009,"Clayton",18185,31590,574458,4093,177,-0.0034,0.15,239721,39441,14715,24726,257875,46832,28959,17440,27558,130158,11422,10855,114809,-5111,-2469,-2764,122,279162,257875,21287,-5111,16176,1623,0,14553,7025,1181,22759,109563
"3092",2009,"Clinton",49147,35517,1745551,4205,198,-0.0034,0.15,266161,30647,10338,20309,233041,18189,22995,23207,45158,68438,10739,9475,103278,-4998,-1561,-3551,114,296808,233041,63767,-4998,58769,5597,0,53172,6136,1003,60311,197723
"3093",2009,"Crawford",16944,36117,611963,4608,199,-0.0034,0.15,340012,31796,7615,24181,265816,50615,45639,22318,38449,116467,8588,8532,91675,-7630,-2612,-5154,136,371808,265816,105992,-7630,98362,3888,0,94474,5733,859,101066,223545
"3094",2009,"Dallas",64489,43490,2804627,4859,184,-0.0034,0.15,227150,29930,6061,23869,182769,17434,16430,16727,24511,78755,6610,22691,78366,-4913,-549,-4440,76,257080,182769,74311,-4913,69398,5908,0,63490,16656,2191,82337,148395
"3095",2009,"Davis",8701,24681,214747,2691,122,-0.0034,0.15,65689,11465,4988,6477,84609,17650,7045,4562,9208,33670,3749,3103,39292,-4755,-1039,-3758,NA,77154,84609,-7455,-4755,-12210,-5006,0,-7204,2136,329,-4739,32019
"3096",2009,"Decatur",8506,23813,202550,1957,125,-0.0034,0.15,59809,17477,4295,13182,69209,12741,8069,3566,6559,30020,2938,2497,32839,-3988,-1038,-2981,NA,77286,69209,8077,-3988,4089,256,0,3833,1752,284,5869,29789
"3097",2009,"Delaware",17755,32825,582816,5029,209,-0.0034,0.15,324630,35012,12940,22072,348464,64151,63325,18590,31171,207197,13576,10422,147229,-5349,-3941,-1568,160,359642,348464,11178,-5349,5829,334,0,5495,6893,1213,13601,117433
"3098",2009,"Des Moines",40379,35306,1425605,4220,196,-0.0034,0.15,90012,14816,4623,10193,73608,4520,2523,9827,17186,17248,3752,2590,33210,-3125,-323,-2843,NA,104828,73608,31220,-3125,28095,3842,0,24253,1232,186,25671,72764
"3099",2009,"Dickinson",16666,41234,687207,4868,168,-0.0034,0.15,158564,13600,4453,9147,125714,12518,19658,12993,20239,38527,4995,6072,49239,-3804,-721,-3141,58,172164,125714,46450,-3804,42646,4913,0,37733,3620,500,41853,120037
"3100",2009,"Dubuque",92948,35380,3288471,4683,205,-0.0034,0.15,262645,33076,13953,19123,273371,56166,49086,13779,24283,180657,12232,11094,106731,-5536,-3799,-1864,127,295721,273371,22350,-5536,16814,721,0,16093,7132,1173,24398,81988
"3101",2009,"Emmet",10361,32770,339527,5045,161,-0.0034,0.15,226658,14318,6112,8206,202591,45840,37404,14640,26642,100043,5899,5543,66623,-4573,-1512,-3171,110,240976,202591,38385,-4573,33812,4553,0,29259,3775,536,33570,126615
"3102",2009,"Fayette",20939,30234,633075,4576,191,-0.0034,0.15,299701,39654,14873,24781,298950,60549,27294,21467,35235,145731,12434,12047,129924,-6621,-2311,-4467,157,339355,298950,40405,-6621,33784,4127,0,29657,8409,1243,39309,153970
"3103",2009,"Floyd",16248,33370,542193,4659,178,-0.0034,0.15,199104,24555,8216,16339,183651,22373,20608,17997,27764,61382,8210,7087,79612,-4374,-1135,-3328,89,223659,183651,40008,-4374,35634,5154,0,30480,5444,838,36762,137722
"3104",2009,"Franklin",10656,37480,399383,4786,221,-0.0034,0.15,365871,26253,8867,17386,315934,80389,56163,22116,35404,182571,9974,12068,99820,-5264,-2939,-2509,184,392124,315934,76190,-5264,70926,9558,0,61368,7774,1133,70275,183300
"3105",2009,"Fremont",7453,40988,305487,3840,168,-0.0034,0.15,124877,20296,5932,14364,82182,3073,1847,10669,15811,10849,4033,4333,42416,-4837,-332,-4544,NA,145173,82182,62991,-4837,58154,8706,0,49448,2779,414,52641,114028
"3106",2009,"Greene",9329,39677,370145,4797,190,-0.0034,0.15,250465,25296,7785,17511,208619,22928,42136,20973,32901,75088,7435,7000,75246,-5689,-1108,-4679,98,275761,208619,67142,-5689,61453,8972,0,52481,4206,625,57312,175377
"3107",2009,"Grundy",12447,42232,525658,5434,241,-0.0034,0.15,267365,32940,7921,25019,232030,36687,28088,18621,34547,77092,8929,12282,92876,-5356,-1346,-4126,116,300305,232030,68275,-5356,62919,8685,0,54234,7452,1058,62744,190273
"3108",2009,"Guthrie",10939,37555,410819,4146,158,-0.0034,0.15,228831,16599,8380,8219,181619,27859,26563,14730,21346,104611,7171,9405,74545,-4451,-1011,-3524,84,245430,181619,63811,-4451,59360,10324,0,49036,7515,1078,57629,124220
"3109",2009,"Hamilton",15739,36943,581452,5507,202,-0.0034,0.15,359732,33085,8695,24390,326627,89858,46636,19976,31424,181548,11786,14762,112185,-4073,-2143,-2123,193,392817,326627,66190,-4073,62117,7159,0,54958,12467,1741,69166,178184
"3110",2009,"Hancock",11371,36962,420292,4826,204,-0.0034,0.15,336653,25187,8545,16642,284967,59501,33610,24656,38114,143474,9439,9952,109695,-4071,-1406,-2820,155,361840,284967,76873,-4071,72802,15131,0,57671,7238,1046,65955,193179
"3111",2009,"Hardin",17535,36568,641216,4970,197,-0.0034,0.15,413565,35073,8397,26676,376350,122190,66634,19249,28858,257576,9677,13654,116088,-6104,-4273,-2061,230,448638,376350,72288,-6104,66184,6415,NA,59768,11256,1654,72678,155989
"3112",2009,"Harrison",14972,38815,581138,4326,195,-0.0034,0.15,198763,20885,7752,13133,133925,7540,7803,16995,27280,23659,6531,5284,62492,-4422,-653,-3836,67,219648,133925,85723,-4422,81301,6051,0,75250,2992,438,78680,175104
"3113",2009,"Henry",20202,30561,617402,3904,178,-0.0034,0.15,129262,14331,7512,6819,123718,25373,12655,9055,16886,50862,5252,4589,49908,-4161,-700,-3529,68,143593,123718,19875,-4161,15714,2326,0,13388,3009,453,16850,78400
"3114",2009,"Howard",9568,32860,314402,3822,157,-0.0034,0.15,193289,22573,7944,14629,188204,37326,18107,14831,22884,80896,8262,6423,80371,-3798,-1628,-2273,103,215862,188204,27658,-3798,23860,2099,0,21761,5122,775,27658,112393
"3115",2009,"Humboldt",9843,38425,378222,5257,198,-0.0034,0.15,197248,20839,6578,14261,158438,20125,12852,15885,27070,44514,6768,3814,71924,-4156,-803,-3435,82,218087,158438,59649,-4156,55493,4384,0,51109,2643,385,54137,152734
"3116",2009,"Ida",7090,45754,324395,4961,222,-0.0034,0.15,214808,23762,5739,18023,159275,22379,22174,15114,24686,66091,6334,6593,61995,-4573,-1580,-3073,80,238570,159275,79295,-4573,74722,9040,0,65682,4506,640,70828,148717
"3117",2009,"Iowa",16406,36502,598858,4183,203,-0.0034,0.15,206541,25579,9071,16508,191955,26896,26738,14791,25723,80411,9119,9330,79358,-6574,-1591,-5073,90,232120,191955,40165,-6574,33591,4160,0,29431,6599,1074,37104,126130
"3118",2009,"Jackson",19841,32011,635123,3886,185,-0.0034,0.15,151714,21365,8880,12485,150815,18691,28079,9389,16759,78745,7044,7093,63760,-5606,-2052,-3613,59,173079,150815,22264,-5606,16658,1710,0,14948,5106,791,20845,72969
"3119",2009,"Jasper",36879,32016,1180718,4343,197,-0.0034,0.15,309643,22977,8350,14627,220692,33080,17735,23878,37582,74759,9397,7171,91849,-7359,-1632,-5854,127,332620,220692,111928,-7359,104569,11827,0,92742,5568,818,99128,234884
"3120",2009,"Jefferson",16782,30159,506126,3100,178,-0.0034,0.15,77139,15977,6598,9379,79076,11377,6717,6505,11997,26135,3653,2652,36175,-3393,-544,-2889,NA,93116,79076,14040,-3393,10647,1357,0,9290,1787,290,11367,51004
"3121",2009,"Johnson",129864,38802,5038924,5052,175,-0.0034,0.15,222765,31600,7492,24108,191210,30319,16988,15317,27870,82189,9856,11452,79408,-5511,-1540,-4070,99,254365,191210,63155,-5511,57644,7727,0,49917,6627,977,57521,140576
"3122",2009,"Jones",20562,30517,627488,4301,207,-0.0034,0.15,219630,26494,8572,17922,204057,24841,34802,16116,29130,85558,9410,8130,81628,-3860,-1868,-2086,94,246124,204057,42067,-3860,38207,6248,0,31959,5312,899,38170,134072
"3123",2009,"Keokuk",10552,33732,355942,3643,179,-0.0034,0.15,172305,24750,10466,14284,156422,28207,16313,12130,22403,59806,7042,4604,65723,-5711,-1319,-4475,83,197055,156422,40633,-5711,34922,4103,0,30819,2917,425,34161,112499
"3124",2009,"Kossuth",15630,43168,674714,5080,200,-0.0034,0.15,559471,39511,15109,24402,457489,87951,74358,37729,59100,223515,16973,16559,164819,-10661,-3941,-6958,238,598982,457489,141493,-10661,130832,16542,NA,114289,11722,1676,127687,335956
"3125",2009,"Lee",35856,30738,1102133,3825,184,-0.0034,0.15,99511,11530,5341,6189,96103,6966,4343,10685,18981,22664,5749,4041,45338,-3848,-589,-3309,50,111041,96103,14938,-3848,11090,1971,0,9119,2942,515,12576,76847
"3126",2009,"Linn",210217,39991,8406822,5201,198,-0.0034,0.15,198403,27998,8122,19876,181297,19337,13216,18412,33501,45584,9380,9913,77538,-4828,-1283,-3639,94,226401,181297,45104,-4828,40276,5166,0,35110,6816,971,42897,152819
"3127",2009,"Louisa",11416,31644,361243,4422,176,-0.0034,0.15,118430,12046,5820,6226,108976,20232,12096,8685,15210,45562,3890,5405,43458,-3301,-793,-2565,57,130476,108976,21500,-3301,18199,3341,0,14858,4047,562,19467,72868
"3128",2009,"Lucas",8948,27067,242196,2163,125,-0.0034,0.15,35918,6526,3532,2994,41824,7467,3952,2296,4346,16860,2100,1524,20139,-2989,-819,-2189,NA,42444,41824,620,-2989,-2369,-280,0,-2089,966,161,-962,19058
"3129",2009,"Lyon",11557,36935,426862,5404,191,-0.0034,0.15,479322,31267,7194,24073,417210,115347,111184,19748,25839,317179,10415,16924,117753,-9378,-5401,-4182,205,510589,417210,93379,-9378,84001,14293,NA,69707,12660,1862,84229,162143
"3130",2009,"Madison",15510,35462,550010,3721,142,-0.0034,0.15,132380,12789,5018,7771,100290,16218,5000,8986,13638,45732,4330,7033,45085,-4660,-835,-3876,51,145169,100290,44879,-4660,40219,6610,0,33609,5376,763,39748,86648
"3131",2009,"Mahaska",22364,33467,748446,3867,168,-0.0034,0.15,230228,25760,8995,16765,204673,40804,41527,12795,19613,122087,8017,8438,73479,-6169,-1863,-4402,96,255988,204673,51315,-6169,45146,7853,0,37293,5769,865,43927,108141
"3132",2009,"Marion",33468,32593,1090821,3765,174,-0.0034,0.15,111313,15984,5813,10171,88954,10115,5644,9969,14248,24905,4142,3995,40841,-4775,-552,-4268,NA,127297,88954,38343,-4775,33568,4291,0,29277,2587,387,32251,86408
"3133",2009,"Marshall",40280,34212,1378049,4598,194,-0.0034,0.15,220460,22302,7639,14663,183694,21110,11693,19443,32625,48383,8517,10968,79338,-5573,-1096,-4572,95,242762,183694,59068,-5573,53495,8975,0,44520,7410,1091,53021,172077
"3134",2009,"Mills",15056,43242,651052,4288,168,-0.0034,0.15,96330,12386,4563,7823,63509,798,667,9866,14422,3184,3157,3695,30904,-4405,-172,-4265,NA,108716,63509,45207,-4405,40802,5021,0,35781,1864,380,38025,93146
"3135",2009,"Mitchell",10763,36861,396739,4618,166,-0.0034,0.15,264925,23348,6505,16843,242165,49546,36169,18110,28778,123028,9097,8856,91609,-4052,-2549,-1628,125,288273,242165,46108,-4052,42056,3559,0,38497,6231,939,45667,141897
"3136",2009,"Monona",9247,38270,353880,3934,204,-0.0034,0.15,219629,21414,6706,14708,156262,9204,15386,19089,33025,29487,7372,5063,67123,-4494,-593,-3975,74,241043,156262,84781,-4494,80287,5286,0,75001,2803,413,78217,190142
"3137",2009,"Monroe",7924,34306,271840,2731,125,-0.0034,0.15,49995,9247,3185,6062,52945,4756,3622,3939,8600,17639,3093,1878,27057,-3435,-683,-2776,NA,59242,52945,6297,-3435,2862,130,0,2732,1201,179,4112,32356
"3138",2009,"Montgomery",10803,34206,369525,3476,169,-0.0034,0.15,136811,17456,5260,12196,100699,14474,5953,10197,14854,40259,4708,8481,42032,-4734,-621,-4165,52,154267,100699,53568,-4734,48834,5889,0,42945,6942,967,50854,96552
"3139",2009,"Muscatine",42783,34720,1485415,4673,197,-0.0034,0.15,130593,14077,5787,8290,125385,14551,7853,12108,22085,34142,5560,5147,58081,-2756,-652,-2168,64,144670,125385,19285,-2756,16529,2588,0,13941,3468,530,17939,96451
"3140",2009,"O'Brien",14412,38078,548784,6153,213,-0.0034,0.15,413074,25255,7987,17268,355254,95343,90301,20748,32467,227057,8947,8908,98540,-8794,-3530,-5451,187,438329,355254,83075,-8794,74281,9185,NA,65095,5364,776,71235,186017
"3141",2009,"Osceola",6509,37143,241762,5467,200,-0.0034,0.15,310926,24675,6499,18176,267384,77669,46180,15471,22970,185536,8028,13573,83493,-6148,-2724,-3572,148,335601,267384,68217,-6148,62069,10944,0,51125,9945,1414,62484,125390
"3142",2009,"Page",15885,31590,501815,3195,159,-0.0034,0.15,111177,16087,6019,10068,89225,5734,5042,10251,16960,16006,4303,4514,42421,-5814,-590,-5267,NA,127264,89225,38039,-5814,32225,2452,0,29773,2670,389,32832,95171
"3143",2009,"Palo Alto",9510,38139,362702,4958,173,-0.0034,0.15,400579,32172,8695,23477,330890,89879,60679,23356,37048,191239,10014,11162,98752,-5522,-2591,-3121,190,432751,330890,101861,-5522,96339,16146,0,80193,7505,1061,88759,209340
"3144",2009,"Plymouth",24904,40587,1010773,5483,177,-0.0034,0.15,559103,59017,9821,49196,483110,125174,116064,26999,40098,304118,12498,13332,148945,-13266,-5588,-7914,236,618120,483110,135010,-13266,121744,9468,NA,112275,8295,1232,121802,254985
"3145",2009,"Pocahontas",7395,41382,306020,5255,190,-0.0034,0.15,271546,26369,8523,17846,205799,34292,22808,21071,36502,72073,8121,7588,75417,-5871,-1199,-4789,117,297915,205799,92116,-5871,86245,11375,0,74870,5516,803,81189,199473
"3146",2009,"Polk",425737,42216,17973043,4718,193,-0.0034,0.15,145557,22977,3999,18978,117312,5566,5289,16016,23187,16070,5518,7145,54591,-2712,-402,-2368,58,168534,117312,51222,-2712,48510,6747,0,41763,5049,747,47559,129487
"3147",2009,"Pottawattamie",92395,35644,3293295,4656,176,-0.0034,0.15,360913,29788,10032,19756,271259,32630,52844,34431,37775,99836,10675,8916,93988,-9479,-1978,-7634,133,390701,271259,119442,-9479,109963,27833,0,82130,6011,911,89052,261077
"3148",2009,"Poweshiek",18958,37373,708523,4197,186,-0.0034,0.15,204768,17166,8032,9134,146913,16942,8622,13901,25847,54213,6118,7055,68428,-6306,-690,-5690,74,221934,146913,75021,-6306,68715,13969,0,54746,5491,922,61159,150555
"3149",2009,"Ringgold",5119,27805,142335,2339,160,-0.0034,0.15,81142,10237,6449,3788,84060,18502,9803,4086,8069,38020,3748,3101,36751,-5137,-1133,-4045,NA,91379,84060,7319,-5137,2182,68,0,2114,2253,356,4723,43122
"3150",2009,"Sac",10342,39170,405101,5405,204,-0.0034,0.15,422244,32626,7731,24895,377782,108344,88999,20150,29707,239231,10476,13307,106799,-7514,-3429,-4286,201,454870,377782,77088,-7514,69574,11495,NA,58078,9601,1390,69069,183013
"3151",2009,"Scott",163582,41768,6832527,6361,191,-0.0034,0.15,174081,28195,5795,22400,166161,19661,10245,16580,29643,42987,7874,7673,74485,-2653,-910,-1829,86,202276,166161,36115,-2653,33462,6380,0,27082,5444,809,33335,131094
"3152",2009,"Shelby",12165,41482,504624,4625,188,-0.0034,0.15,278261,16637,7648,8989,217894,31085,29602,20518,35087,69806,8362,10378,82862,-6429,-1191,-5346,108,294898,217894,77004,-6429,70575,4014,0,66561,7387,1053,75001,208455
"3153",2009,"Sioux",33587,34660,1164133,6028,204,-0.0034,0.15,1126583,72603,12661,59942,1058313,333109,344475,31991,44689,864010,21379,39027,243643,-16857,-11250,-6124,517,1199186,1058313,140873,-16857,124016,26250,NA,97765,26193,3969,127927,262573
"3154",2009,"Story",89285,34166,3050518,5379,196,-0.0034,0.15,230952,40792,7309,33483,183190,15255,9979,21324,36450,38162,8293,14793,77096,-4112,-572,-3634,94,271744,183190,88554,-4112,84442,12067,0,72375,5934,892,79201,192790
"3155",2009,"Tama",17833,34775,620148,4625,186,-0.0034,0.15,287869,28618,11149,17469,202961,21012,21690,19115,37689,66427,8898,9146,85411,-7289,-1353,-6038,102,316487,202961,113526,-7289,106237,12942,0,93295,5730,810,99835,221442
"3156",2009,"Taylor",6355,34345,218260,2530,174,-0.0034,0.15,146822,15094,6544,8550,112288,19365,13084,6872,10705,67769,5034,8420,48808,-4850,-923,-3979,52,161916,112288,49628,-4850,44778,1309,0,43469,6098,862,50429,79053
"3157",2009,"Union",12527,31126,389914,2826,206,-0.0034,0.15,102939,11267,4399,6868,97276,20276,16804,4963,7696,53515,3444,3888,40205,-4845,-1256,-3632,NA,114206,97276,16930,-4845,12085,807,0,11278,2737,395,14410,49424
"3158",2009,"Van Buren",7628,27295,208208,2872,155,-0.0034,0.15,98882,9653,4871,4782,90139,24569,13029,5099,9838,50542,3396,2961,31247,-3904,-772,-3183,51,108535,90139,18396,-3904,14492,3242,0,11250,2021,311,13582,48340
"3159",2009,"Wapello",35481,30461,1080771,3096,173,-0.0034,0.15,63536,9216,4869,4347,66911,6904,5095,5368,10321,16762,3559,2505,33159,-3018,-487,-2562,NA,72752,66911,5841,-3018,2823,295,0,2528,1786,255,4569,46774
"3160",2009,"Warren",45926,37502,1722297,3873,170,-0.0034,0.15,88498,14631,5195,9436,83619,6361,3733,8004,12023,16951,4234,3512,45752,-4661,-673,-4024,NA,103129,83619,19510,-4661,14849,1476,0,13373,1986,301,15660,71547
"3161",2009,"Washington",21692,37287,808838,4734,195,-0.0034,0.15,305965,34817,11722,23095,280951,79142,41684,14226,24884,182395,9797,9340,101878,-6672,-3115,-3710,153,340782,280951,59831,-6672,53159,14150,0,39009,5659,857,45525,123570
"3162",2009,"Wayne",6393,26687,170607,2074,123,-0.0034,0.15,58966,11749,5677,6072,64358,4599,2747,5599,10433,14424,3208,2364,35408,-3656,-683,-3001,NA,70715,64358,6357,-3656,2701,125,0,2576,1270,320,4166,44542
"3163",2009,"Webster",38316,34283,1313573,5344,208,-0.0034,0.15,314014,23087,10285,12802,257514,40261,17253,25677,42981,84792,10053,10290,110999,-4789,-888,-4040,139,337101,257514,79587,-4789,74798,7062,0,67736,7084,1041,75861,229222
"3164",2009,"Winnebago",10917,32478,354566,4522,180,-0.0034,0.15,192470,19279,7053,12226,176226,43675,15779,14584,22216,76241,6591,10215,63166,-3711,-790,-3024,103,211749,176226,35523,-3711,31812,5791,0,26021,7930,1163,35114,116229
"3165",2009,"Winneshiek",21025,34014,715148,3896,184,-0.0034,0.15,204554,42279,14466,27813,227070,37494,21271,14237,23407,115621,10527,13345,106789,-4612,-1902,-2812,102,246833,227070,19763,-4612,15151,738,0,14413,8902,1355,24670,88933
"3166",2009,"Woodbury",101581,33224,3374892,4002,196,-0.0034,0.15,304548,40039,9994,30045,237923,31132,36711,22429,35138,93655,8320,9163,95030,-7159,-1725,-5547,113,344587,237923,106664,-7159,99505,7706,0,91799,6122,910,98831,210893
"3167",2009,"Worth",7610,33392,254115,4534,174,-0.0034,0.15,122769,15524,6126,9398,105004,5277,3666,13282,22907,14914,6129,2615,51128,-2454,-285,-2224,55,138293,105004,33289,-2454,30835,1870,0,28965,1243,209,30417,107855
"3168",2009,"Wright",13262,40164,532658,5401,208,-0.0034,0.15,453481,19828,9402,10426,383384,109590,41096,18556,30403,281627,9540,19613,154586,-7024,-2440,-4793,209,473309,383384,89925,-7024,82901,12353,NA,70547,15338,2250,88135,171854
"3169",2010,"Adair",7676,34617,265718,3923,165,0.0164,0.14,150573,13904,8290,5614,138670,15641,15504,11797,21384,58250,4979,7589,61776,-4157,457,-4214,-400,164477,138670,25807,-4157,21650,5105,0,16545,5359,870,22774,92323
"3170",2010,"Adams",4028,38766,156148,3187,177,0.0164,0.14,90866,11768,8232,3536,84592,11750,13377,6366,9695,35123,3849,3667,35888,-2654,318,-2733,-239,102634,84592,18042,-2654,15388,1349,0,14039,2461,545,17045,55743
"3171",2010,"Allamakee",14347,31729,455221,3376,158,0.0164,0.14,162276,15820,8518,7302,148420,25750,18467,7671,13113,108224,6523,9086,67810,-4274,619,-4485,-408,178096,148420,29676,-4274,25402,1463,0,23939,6326,1046,31311,54052
"3172",2010,"Appanoose",12883,28226,363630,2196,133,0.0164,0.14,38668,8725,6203,2522,46023,2497,2432,3693,7193,12887,2474,1793,25941,-697,321,-901,-117,47393,46023,1370,-697,673,NA,0,636,800,142,1578,25781
"3173",2010,"Audubon",6115,42428,259448,5372,186,0.0164,0.14,251853,14064,7304,6760,203267,42049,42530,14910,18920,128636,6744,9001,69113,-5167,383,-4923,-627,265917,203267,62650,-5167,57483,6227,0,51256,6835,1019,59110,123217
"3174",2010,"Benton",26073,39066,1018557,5827,208,0.0164,0.14,316997,23590,12075,11515,251769,21033,39414,20249,38323,117069,9085,13005,110660,-9876,562,-9782,-656,340587,251769,88818,-9876,78942,18702,0,60240,7135,1138,68513,199928
"3175",2010,"Black Hawk",131196,35925,4713215,6394,218,0.0164,0.14,219633,19442,11342,8100,184569,24305,18995,17648,27483,68756,9162,8927,78049,-7317,137,-6868,-586,239075,184569,54506,-7317,47189,11741,0,35448,5756,894,42098,150877
"3176",2010,"Boone",26279,38313,1006825,6225,182,0.0164,0.14,203288,23956,13046,10910,165096,9574,11803,20313,32325,42207,8027,9863,73191,-7956,195,-7641,-510,227244,165096,62148,-7956,54192,24282,0,29910,6962,1077,37949,161081
"3177",2010,"Bremer",24290,38490,934925,5762,215,0.0164,0.14,192177,16391,10841,5550,167937,25422,19241,15693,26376,72177,7292,5240,68673,-6384,206,-6031,-559,208568,167937,40631,-6384,34247,5414,0,28833,3052,499,32384,120000
"3178",2010,"Buchanan",20948,34358,719723,5642,194,0.0164,0.14,319031,25161,13335,11826,270969,44597,35927,22206,36857,134958,10765,8751,111866,-9476,485,-9049,-912,344192,270969,73223,-9476,63747,11086,0,52661,6443,1072,60176,184073
"3179",2010,"Buena Vista",20327,36439,740692,6535,190,0.0164,0.14,452513,27218,9558,17660,363079,112645,80003,22094,32458,265104,9580,10872,95427,-9083,341,-8060,-1364,479731,363079,116652,-9083,107569,29883,NA,77687,7096,1115,85898,187409
"3180",2010,"Butler",14908,38698,576907,5657,207,0.0164,0.14,329657,23494,13960,9534,245812,50107,34310,19137,32051,130927,8665,10297,91245,-9183,274,-8577,-880,353151,245812,107339,-9183,98156,11339,0,86817,7131,1208,95156,198730
"3181",2010,"Calhoun",9668,40165,388311,6536,195,0.0164,0.14,333881,18249,10607,7642,256673,48093,53346,20333,34112,141235,9697,8003,83089,-9434,217,-8803,-848,352130,256673,95457,-9434,86023,14761,0,71262,5517,867,77646,192646
"3182",2010,"Carroll",20830,39712,827204,5949,198,0.0164,0.14,532355,21909,9125,12784,459680,117712,147520,19361,30217,342274,11090,14210,119570,-9800,1150,-9565,-1385,554264,459680,94584,-9800,84784,12176,NA,72609,10430,1697,84736,190081
"3183",2010,"Cass",13950,38621,538765,4831,182,0.0164,0.14,211937,17104,9170,7934,162181,19875,27019,14499,19714,87712,6515,8215,66344,-5794,519,-5862,-451,229041,162181,66860,-5794,61066,8096,0,52970,5060,808,58838,124225
"3184",2010,"Cedar",18494,38330,708868,5362,188,0.0164,0.14,244906,27314,11779,15535,218422,21871,27039,20682,37751,75885,8976,10922,91181,-8248,302,-7890,-660,272220,218422,53798,-8248,45550,12033,0,33517,6601,1086,41204,169021
"3185",2010,"Cerro Gordo",44107,38555,1700554,5704,199,0.0164,0.14,229279,26051,13334,12717,178262,14521,12343,23900,37694,49828,8239,6428,75137,-9086,109,-8582,-613,255330,178262,77068,-9086,67982,8414,0,59568,3389,563,63520,179451
"3186",2010,"Cherokee",12112,40990,496473,6061,195,0.0164,0.14,337311,25204,6924,18280,261276,53060,65186,17478,25319,171389,8894,8461,82878,-7426,840,-7485,-781,362515,261276,101239,-7426,93813,15998,0,77815,4515,756,83086,165922
"3187",2010,"Chickasaw",12424,38409,477193,4850,189,0.0164,0.14,283713,23594,12689,10905,249094,39222,47526,16926,29954,143053,9949,11841,93676,-7565,503,-7356,-712,307307,249094,58213,-7565,50648,10748,0,39900,6585,1076,47561,140660
"3188",2010,"Clarke",9304,29889,278086,2429,133,0.0164,0.14,60978,9504,6740,2764,55453,13878,6482,2624,3916,43921,2107,1943,24503,-836,301,-954,-183,70482,55453,15029,-836,14193,836,0,13357,1035,172,14564,17057
"3189",2010,"Clay",16648,40140,668244,6083,175,0.0164,0.14,332726,19100,8595,10505,254395,49227,53695,20229,29050,159330,7669,15006,79519,-8118,360,-7677,-801,351826,254395,97431,-8118,89313,24414,0,64899,9507,1410,75816,173396
"3190",2010,"Clayton",18085,33529,606380,4464,178,0.0164,0.14,284012,31205,13729,17476,267137,44381,36292,18111,27655,156790,11186,11722,117790,-7911,907,-8049,-769,315217,267137,48080,-7911,40169,6574,0,33595,7272,1329,42196,127222
"3191",2010,"Clinton",49120,36357,1785839,4473,200,0.0164,0.14,272359,28589,14238,14351,242269,17238,28925,24100,45315,82182,10518,10214,105959,-9536,647,-9470,-713,300948,242269,58679,-9536,49143,7635,0,41508,6359,1132,48999,190177
"3192",2010,"Crawford",17144,36133,619466,5427,177,0.0164,0.14,362057,25102,8044,17058,278361,47951,57067,23167,38569,139756,8408,9171,94028,-10357,613,-10117,-853,387159,278361,108798,-10357,98441,6347,0,92094,5958,973,99025,222301
"3193",2010,"Dallas",66673,44252,2950414,5806,178,0.0164,0.14,218448,26290,9455,16835,189268,16523,19546,17372,24596,91559,6473,24358,80400,-5709,165,-5397,-477,244738,189268,55470,-5709,49761,6910,0,42851,17383,2516,62750,126889
"3194",2010,"Davis",8776,24938,218859,3002,140,0.0164,0.14,66874,11720,7135,4585,86971,16727,8938,4737,9241,40442,3672,3343,40313,-1107,359,-1202,-264,78594,86971,-8377,-1107,-9484,-2924,0,-6560,2217,372,-3971,26432
"3195",2010,"Decatur",8437,24287,204907,2085,139,0.0164,0.14,59333,17613,8310,9303,71893,12075,10250,3703,6582,35723,2878,2713,33692,-663,499,-969,-193,76946,71893,5053,-663,4390,449,0,3941,1816,320,6077,23610
"3196",2010,"Delaware",17785,35240,626748,5517,198,0.0164,0.14,378580,30265,14662,15603,365832,60795,78829,19305,31280,247938,13295,11275,151053,-9383,1327,-9708,-1002,408845,365832,43013,-9383,33630,3144,0,30486,7123,1363,38972,130642
"3197",2010,"Des Moines",40288,36965,1489254,4845,192,0.0164,0.14,79022,12655,5460,7195,75543,4283,3142,10205,17245,20706,3675,2921,34072,-2445,73,-2262,-256,91677,75543,16134,-2445,13689,3054,0,10635,1279,211,12125,58316
"3198",2010,"Dickinson",16672,42420,707230,5655,166,0.0164,0.14,168499,12892,6429,6463,131798,11856,24179,13484,20296,46051,4889,6604,50490,-4619,283,-4541,-361,181391,131798,49593,-4619,44974,8452,0,36522,3772,570,40864,122448
"3199",2010,"Dubuque",93888,36747,3450110,5091,217,0.0164,0.14,301548,25398,11883,13515,286735,53229,61382,14310,24368,216253,11980,11964,109502,-6176,1558,-6934,-800,326946,286735,40211,-6176,34035,2383,0,31652,7388,1322,40362,85295
"3200",2010,"Emmet",10284,34447,354248,5960,170,0.0164,0.14,245424,14814,9014,5800,210988,43442,45517,15204,26735,118417,5778,5959,68353,-6041,460,-5810,-691,260238,210988,49250,-6041,43209,9491,0,33718,3930,612,38260,127007
"3201",2010,"Fayette",20864,32132,670395,5118,184,0.0164,0.14,346810,35838,18329,17509,313383,58514,34581,22709,36014,175115,12410,13305,135850,-9291,663,-8970,-984,382648,313383,69265,-9291,59974,11951,0,48023,8743,1411,58177,171695
"3202",2010,"Floyd",16312,34402,561163,5439,169,0.0164,0.14,221881,25213,13669,11544,190522,21202,25478,18690,27860,73174,8041,7573,81678,-7592,247,-7278,-561,247094,190522,56572,-7592,48980,11555,0,37425,5652,947,44024,148707
"3203",2010,"Franklin",10691,40188,429653,5778,206,0.0164,0.14,411123,28050,15766,12284,329875,76184,69592,22967,35527,219298,9769,13425,102411,-10275,222,-9340,-1157,439173,329875,109298,-10275,99023,21768,0,77255,8086,1286,86627,191825
"3204",2010,"Fremont",7430,40101,297948,4586,160,0.0164,0.14,112761,23503,13375,10128,84349,2913,2323,11079,15866,12852,3950,4701,43517,-4396,156,-4309,-243,136264,84349,51915,-4396,47519,11604,0,35915,2888,469,39272,99909
"3205",2010,"Greene",9334,38546,359791,5701,177,0.0164,0.14,256670,24396,12029,12367,220353,21729,51601,21780,33016,90090,7282,7745,77200,-8448,331,-8164,-615,281066,220353,60713,-8448,52265,12447,0,39818,4373,709,44900,166580
"3206",2010,"Grundy",12454,44104,549267,6452,226,0.0164,0.14,308909,26401,8755,17646,241115,34767,34789,19338,34667,92299,8745,13521,95288,-8779,187,-8235,-731,335310,241115,94195,-8779,85416,19232,0,66184,7757,1203,75144,216610
"3207",2010,"Guthrie",10959,37167,407308,4933,176,0.0164,0.14,236214,15760,9933,5827,188506,26401,32033,15297,21421,122786,7023,9851,76480,-4712,362,-4549,-525,251974,188506,63468,-4712,58756,16668,0,42088,7821,1225,51134,113428
"3208",2010,"Hamilton",15650,38075,595872,6634,218,0.0164,0.14,409897,32228,15020,17208,336461,85157,56923,20744,31534,215898,11543,15462,115098,-10680,88,-9559,-1209,442125,336461,105664,-10680,94984,17856,0,77128,12988,1986,92102,193999
"3209",2010,"Hancock",11318,38591,436775,5810,196,0.0164,0.14,365903,22903,11138,11765,293333,56389,40619,25605,38247,169129,9245,10686,112542,-9982,163,-9172,-973,388806,293333,95473,-9982,85491,28983,0,56508,7531,1188,65227,196774
"3210",2010,"Hardin",17536,39643,695188,5987,196,0.0164,0.14,493182,32863,14042,18821,389757,115799,81948,19990,28959,306906,9477,14482,119102,-10806,347,-9705,-1448,526045,389757,136288,-10806,125482,19838,NA,105645,11707,1878,119230,186276
"3211",2010,"Harrison",14922,37748,563271,5151,196,0.0164,0.14,183059,17297,8023,9274,138301,7145,9738,17649,27374,28012,6396,5885,64114,-8214,260,-8051,-423,200356,138301,62055,-8214,53841,6537,0,47304,3112,498,50914,155047
"3212",2010,"Henry",20131,31358,631272,4484,178,0.0164,0.14,126403,14211,9383,4828,127355,24069,15492,9411,16961,60336,5149,5019,51254,-2635,150,-2358,-427,140614,127355,13259,-2635,10624,2565,0,8059,3127,514,11700,66067
"3213",2010,"Howard",9560,35817,342413,4364,167,0.0164,0.14,233716,21022,10687,10335,193736,35373,22653,15402,22964,97408,8092,6794,82458,-7120,358,-6829,-649,254738,193736,61002,-7120,53882,7733,0,46149,5321,878,52348,136308
"3214",2010,"Humboldt",9807,37123,364064,6379,196,0.0164,0.14,178947,18836,8761,10075,163211,19073,15893,16497,27165,53096,6630,4162,73791,-5870,180,-5537,-513,197783,163211,34572,-5870,28702,3699,0,25003,2748,437,28188,125851
"3215",2010,"Ida",7077,45029,318667,5847,232,0.0164,0.14,226280,18681,5967,12714,166024,21208,27479,15696,24772,78166,6203,7061,63605,-6272,570,-6338,-504,244961,166024,78937,-6272,72665,14339,0,58326,4691,729,63746,148114
"3216",2010,"Iowa",16338,37797,617521,4965,193,0.0164,0.14,212999,24271,12604,11667,200167,25489,33098,15360,25812,95521,8931,10059,81418,-5269,587,-5289,-567,237270,200167,37103,-5269,31834,6430,0,25404,6839,1211,33454,117478
"3217",2010,"Jackson",19848,33183,658612,4183,180,0.0164,0.14,167749,18690,9856,8834,159411,17713,35359,9750,16818,94067,6899,7457,65415,-4484,975,-5088,-371,186439,159411,27028,-4484,22544,3776,0,18768,5301,894,24963,73682
"3218",2010,"Jasper",36816,31772,1169711,5102,180,0.0164,0.14,291116,21237,10888,10349,227050,31350,22160,24798,37713,89749,9204,7591,94234,-7742,342,-7286,-798,312353,227050,85303,-7742,77561,14309,0,63252,5791,929,69972,201367
"3219",2010,"Jefferson",16800,30406,510823,3562,173,0.0164,0.14,74174,16205,9576,6629,81524,10782,8359,6755,12039,31262,3578,2896,37115,-1972,136,-1860,-248,90379,81524,8855,-1972,6883,1431,0,5452,1851,327,7630,42912
"3220",2010,"Johnson",131238,39607,5197996,5750,182,0.0164,0.14,224147,27870,10857,17013,197349,28732,21091,15907,27967,98289,9653,12528,81471,-4869,411,-4661,-619,252017,197349,54668,-4869,49799,10888,0,38911,6891,1108,46910,125858
"3221",2010,"Jones",20673,30715,634970,4584,211,0.0164,0.14,232901,25942,13281,12661,214563,23541,43141,16737,29232,101400,9216,8949,83747,-7509,730,-7651,-588,258843,214563,44280,-7509,36771,9808,0,26963,5496,1010,33469,131501
"3222",2010,"Keokuk",10501,32770,344120,4300,182,0.0164,0.14,156132,25038,14942,10096,161609,26731,20370,12597,22481,71741,6897,5104,67429,-3874,274,-3630,-518,181170,161609,19561,-3874,15687,3006,0,12681,3034,483,16198,84391
"3223",2010,"Kossuth",15519,46163,716398,6194,191,0.0164,0.14,600612,37632,20378,17254,477498,83351,92165,39183,59305,267939,16621,17775,169098,-16790,416,-15712,-1494,638244,477498,160746,-16790,143956,29690,NA,114267,12203,1908,128378,332673
"3224",2010,"Lee",35842,31367,1124272,4243,154,0.0164,0.14,92277,10375,5993,4382,98652,6601,5470,11096,19047,27224,5631,4292,46515,-2215,180,-2084,-311,102652,98652,4000,-2215,1785,517,0,1268,3040,577,4885,65053
"3225",2010,"Linn",211564,41062,8687204,5676,206,0.0164,0.14,202830,24999,10956,14043,187210,18324,16770,19120,33618,55025,9187,10639,79552,-7278,369,-7054,-593,227829,187210,40619,-7278,33341,6975,0,26366,7094,1104,34564,147805
"3226",2010,"Louisa",11374,32197,366203,5019,173,0.0164,0.14,117824,11933,7527,4406,112572,19175,14931,9019,15263,54429,3810,5788,44586,-3076,79,-2800,-355,129757,112572,17185,-3076,14109,4225,0,9884,4215,640,14739,63395
"3227",2010,"Lucas",8895,27635,245817,2305,125,0.0164,0.14,34208,7528,5398,2130,43353,7076,5128,2385,4360,20078,2057,1685,20662,-454,401,-733,-122,41736,43353,-1617,-454,-2071,-185,0,-1886,999,180,-707,14130
"3228",2010,"Lyon",11585,37797,437876,6277,206,0.0164,0.14,547712,23374,6370,17004,442070,109314,137420,20508,25929,378060,10200,17888,120811,-8890,1596,-9202,-1284,571086,442070,129016,-8890,120126,33342,NA,86785,13168,2119,102072,169652
"3229",2010,"Madison",15733,35611,560268,4359,143,0.0164,0.14,126413,13229,7727,5502,102348,15369,6059,9333,13685,53230,4241,7406,46255,-2372,394,-2447,-319,139642,102348,37294,-2372,34922,9363,0,25559,5596,868,32023,73183
"3230",2010,"Mahaska",22399,33559,751698,4446,176,0.0164,0.14,222137,24430,12588,11842,215143,38669,51090,13287,19681,145341,7852,9177,75387,-4234,415,-4043,-606,246567,215143,31424,-4234,27190,7715,0,19475,5995,980,26450,76796
"3231",2010,"Marion",33261,32851,1092644,4175,174,0.0164,0.14,93918,17351,10155,7196,91607,9586,7080,10353,14298,29895,4056,4332,41902,-2587,207,-2513,-281,111269,91607,19662,-2587,17075,3561,0,13514,2689,438,16641,64023
"3232",2010,"Marshall",40706,34645,1410249,5478,200,0.0164,0.14,238064,20536,10178,10358,189193,20006,14705,20192,32739,58355,8341,11812,81398,-7848,263,-7512,-599,258600,189193,69407,-7848,61559,16846,0,44713,7705,1238,53656,179709
"3233",2010,"Mills",15060,42832,645055,5121,177,0.0164,0.14,93811,14575,9049,5526,65258,755,875,10246,14472,3795,3092,4111,31707,-4396,88,-4282,-202,108386,65258,43128,-4396,38732,7775,0,30957,1913,421,33291,90016
"3234",2010,"Mitchell",10797,38334,413894,5392,175,0.0164,0.14,309846,21187,9288,11899,252428,46954,45353,18808,28878,148090,8909,9539,93987,-7921,754,-7891,-784,331033,252428,78605,-7921,70684,9757,0,60927,6473,1061,68461,161756
"3235",2010,"Monona",9238,37027,342058,4676,197,0.0164,0.14,215081,17175,6793,10382,162302,8704,19236,19782,33073,35387,7206,5572,68729,-8242,247,-8022,-467,232256,162302,69954,-8242,61712,6627,0,55085,2915,468,58468,179694
"3236",2010,"Monroe",7984,34411,274736,3055,154,0.0164,0.14,43657,11076,6787,4289,54701,4507,4608,4091,8630,20897,3029,2077,27759,-663,327,-838,-152,54733,54701,NA,-663,-631,-55,0,-576,1248,205,877,22760
"3237",2010,"Montgomery",10714,34768,372505,4151,182,0.0164,0.14,137379,18434,9826,8608,102954,13717,7153,10589,14906,46593,4612,8854,43123,-3880,338,-3893,-325,155813,102954,52859,-3880,48979,9635,0,39344,7232,1100,47676,90786
"3238",2010,"Muscatine",42732,36100,1542609,5114,190,0.0164,0.14,128341,14332,8462,5870,128860,13790,9751,12574,22163,40774,5446,5547,59589,-3932,206,-3739,-399,142673,128860,13813,-3932,9881,2524,0,7357,3601,599,11557,87567
"3239",2010,"O'Brien",14386,39414,567014,7148,219,0.0164,0.14,453713,19963,7760,12203,375408,90356,111208,21546,32580,270531,8763,9856,101099,-8631,800,-8256,-1175,473676,375408,98268,-8631,89637,18079,NA,71559,5580,880,78019,183182
"3240",2010,"Osceola",6448,39366,253835,6350,201,0.0164,0.14,350668,18823,5994,12829,278317,73606,57163,16067,23050,222656,7863,14907,85661,-6466,451,-5988,-929,369491,278317,91174,-6466,84708,24363,0,60345,10352,1609,72306,128012
"3241",2010,"Page",15933,31973,509421,3816,160,0.0164,0.14,116142,19180,12063,7117,92151,5433,6368,10646,17019,18888,4215,4948,43522,-4588,271,-4588,-271,135322,92151,43171,-4588,38583,4787,0,33796,2777,442,37015,97254
"3242",2010,"Palo Alto",9397,38038,357440,5954,169,0.0164,0.14,433259,26618,10052,16566,344696,85178,74450,24255,37177,228070,9808,12512,101316,-9711,222,-8740,-1193,459877,344696,115181,-9711,105470,28834,NA,76637,7815,1207,85659,205189
"3243",2010,"Plymouth",24993,41237,1030632,6462,188,0.0164,0.14,610689,44227,9539,34688,510699,118628,143842,28039,40238,363446,12239,14900,152813,-11781,1208,-11509,-1480,654916,510699,144217,-11781,132436,16800,NA,115637,8624,1399,125660,247243
"3244",2010,"Pocahontas",7283,39776,289686,6345,177,0.0164,0.14,271243,21664,9057,12607,212852,32497,28323,21882,36629,86639,7954,8192,77375,-8943,146,-8354,-735,292907,212852,80055,-8943,71112,15299,0,55813,5738,912,62463,184604
"3245",2010,"Polk",432256,42712,18462461,5554,185,0.0164,0.14,121966,21250,7865,13385,120930,5276,6556,16633,23267,18986,5405,7785,56008,-3498,141,-3276,-363,143216,120930,22286,-3498,18788,4262,0,14526,5249,846,20621,102980
"3246",2010,"Pottawattamie",93385,35864,3349120,5553,183,0.0164,0.14,372000,30644,16695,13949,286729,30924,65626,35758,37908,118664,10455,9630,96428,-10303,907,-10373,-837,402644,286729,115915,-10303,105612,43606,0,62006,6244,1030,69280,253336
"3247",2010,"Poweshiek",18899,37970,717589,4979,184,0.0164,0.14,195581,17230,10762,6468,150450,16056,10401,14436,25937,63378,5992,7423,70205,-6345,270,-6153,-462,212811,150450,62361,-6345,56016,18574,0,37442,5684,1037,44163,132203
"3248",2010,"Ringgold",5137,28808,147989,2609,166,0.0164,0.14,81024,12096,9404,2692,87017,17534,12387,4243,8097,45319,3671,3379,37706,-1411,415,-1567,-259,93120,87017,6103,-1411,4692,238,0,4454,2337,402,7193,35705
"3249",2010,"Sac",10349,41484,429322,6328,198,0.0164,0.14,482039,25741,8183,17558,396645,102676,109131,20926,29811,284189,10260,14268,109573,-9431,739,-8907,-1263,507780,396645,111135,-9431,101704,27410,NA,74295,9991,1581,85867,197850
"3250",2010,"Scott",165759,43874,7272593,6699,213,0.0164,0.14,167521,22644,6837,15807,170704,18633,12746,17219,29747,51387,7711,8230,76418,-5009,210,-4677,-542,190165,170704,19461,-5009,14452,4495,0,9957,5659,916,16532,116134
"3251",2010,"Shelby",12173,41290,502629,5506,197,0.0164,0.14,279652,14179,7813,6366,227017,29435,36848,21289,35180,83949,8183,11132,84950,-8676,308,-8308,-676,293831,227017,66814,-8676,58138,5393,0,52745,7690,1198,61633,195703
"3252",2010,"Sioux",33726,37520,1265408,7048,200,0.0164,0.14,1331957,52446,10174,42272,1138337,315685,431232,33224,44846,1057692,20937,42445,249968,-12291,3654,-12689,-3256,1384403,1138337,246066,-12291,233775,80720,NA,153057,27214,4501,184772,274265
"3253",2010,"Story",89567,35233,3155673,6434,199,0.0164,0.14,228282,37132,13520,23612,189597,14457,12360,22145,36577,45751,8123,16837,79098,-7951,146,-7504,-593,265414,189597,75817,-7951,67866,15820,0,52046,6166,1012,59224,182531
"3254",2010,"Tama",17743,35046,621814,5502,189,0.0164,0.14,300128,27562,15214,12348,211100,19913,27026,19851,37821,79429,8715,10146,87628,-8371,445,-8178,-638,327690,211100,116590,-8371,108219,21505,0,86714,5965,923,93602,220699
"3255",2010,"Taylor",6313,36077,227752,2929,197,0.0164,0.14,152798,16426,10380,6046,116230,18352,15949,7137,10743,79985,4930,9044,50075,-2686,337,-2699,-324,169224,116230,52994,-2686,50308,2399,0,47909,6349,982,55240,72813
"3256",2010,"Union",12517,32578,407776,3147,189,0.0164,0.14,103003,12639,7779,4860,101774,19216,20879,5154,7723,63557,3373,4181,41248,-1643,425,-1796,-272,115642,101774,13868,-1643,12225,1331,0,10894,2847,449,14190,39446
"3257",2010,"Van Buren",7559,27529,208092,3196,151,0.0164,0.14,96866,9789,6398,3391,93191,23284,16167,5295,9873,60688,3326,3188,32058,-1427,212,-1317,-322,106655,93191,13464,-1427,12037,4392,0,7645,2098,353,10096,36178
"3258",2010,"Wapello",35625,30591,1089809,3569,160,0.0164,0.14,54712,11104,8025,3079,69096,6543,6430,5575,10357,20097,3486,2685,34020,-1580,153,-1539,-194,65816,69096,-3280,-1580,-4860,-970,0,-3890,1860,290,-1740,34615
"3259",2010,"Warren",46317,38315,1774629,4318,177,0.0164,0.14,74968,16786,10106,6680,86226,6028,4791,8311,12065,20276,4147,3945,46939,-1913,287,-1976,-224,91754,86226,5528,-1913,3615,587,0,3028,2062,340,5430,54692
"3260",2010,"Washington",21712,37480,813764,5588,182,0.0164,0.14,321269,31270,14967,16303,290829,75002,51522,14773,24971,218242,9594,10444,104523,-5164,314,-4516,-962,352539,290829,61710,-5164,56546,24552,0,31994,5879,970,38843,103027
"3261",2010,"Wayne",6408,27395,175545,2210,123,0.0164,0.14,54086,15618,11315,4303,66381,4359,3603,5814,10469,16853,3142,2666,36328,-1063,345,-1233,-175,69704,66381,3323,-1063,2260,170,0,2090,1289,351,3730,37233
"3262",2010,"Webster",37884,34663,1313181,6438,205,0.0164,0.14,328687,23773,14703,9070,263931,38154,20961,26665,43133,100399,9846,11292,113880,-10686,132,-9943,-875,352460,263931,88529,-10686,77843,11990,0,65853,7366,1180,74399,228288
"3263",2010,"Winnebago",10840,33672,365000,5443,182,0.0164,0.14,211267,16702,8064,8638,179811,41391,18948,15146,22293,89190,6454,10773,64806,-6717,157,-6228,-646,227969,179811,48158,-6717,41441,12304,0,29137,8247,1321,38705,122077
"3264",2010,"Winneshiek",21057,36759,774029,4350,190,0.0164,0.14,244460,34946,15301,19645,234614,35533,26634,14784,23489,139541,10310,14302,109562,-8012,788,-8161,-639,279406,234614,44792,-8012,36780,2922,0,33858,9247,1536,44641,104919
"3265",2010,"Woodbury",102336,34081,3487687,4754,205,0.0164,0.14,308606,32151,10961,21190,249476,29504,45779,23293,35261,112156,8148,9993,97498,-9210,733,-9232,-711,340757,249476,91281,-9210,82071,10368,0,71703,6365,1032,79100,196450
"3266",2010,"Worth",7585,35204,267021,5376,169,0.0164,0.14,144481,14294,7644,6650,107715,5002,4505,13793,22987,17656,6003,2970,52455,-6678,72,-6403,-347,158775,107715,51060,-6678,44382,4390,0,39992,1286,234,41512,126825
"3267",2010,"Wright",13194,41032,541374,6553,207,0.0164,0.14,473402,21515,14135,7380,391890,103857,49292,19270,30509,330025,9344,21018,158600,-8345,155,-7188,-1312,494917,391890,103027,-8345,94682,23013,NA,71670,15954,2559,90183,143377
